budget,revenue,profit,popularity,runtime,vote_average,genres1
237000000,2787965087,2550965087,150.437577,162,7.2,28
300000000,961000000,661000000,139.082615,169,6.9,12
245000000,880674609,635674609,107.376788,148,6.3,28
250000000,1084939099,834939099,112.31295,165,7.6,28
260000000,284139100,24139100,43.926995,132,6.1,28
258000000,890871626,632871626,115.699814,139,5.9,14
260000000,591794936,331794936,48.681969,100,7.4,16
280000000,1405403694,1125403694,134.279229,141,7.3,28
250000000,933959197,683959197,98.885637,153,7.4,12
250000000,873260194,623260194,155.790452,151,5.7,28
270000000,391081192,121081192,57.925623,154,5.4,12
200000000,586090727,386090727,107.928811,106,6.1,12
200000000,1065659812,865659812,145.847379,151,7,12
255000000,89289910,-165710090,49.046956,149,5.9,28
225000000,662845518,437845518,99.398009,143,6.5,28
225000000,419651413,194651413,53.978602,150,6.3,12
220000000,1519557910,1299557910,144.448633,143,7.4,878
380000000,1045713802,665713802,135.413856,136,6.4,12
225000000,624026776,399026776,52.035179,106,6.2,28
250000000,956019788,706019788,120.965743,144,7.1,28
215000000,752215857,537215857,89.866276,136,6.5,28
200000000,310669540,110669540,37.668301,140,6.2,28
250000000,958400000,708400000,94.370564,161,7.6,12
180000000,372234864,192234864,42.990906,113,5.8,12
207000000,550000000,343000000,61.22601,187,6.6,12
200000000,1845034188,1645034188,100.025899,194,7.5,18
250000000,1153304495,903304495,198.372395,147,7.1,12
209000000,303025485,94025485,64.928382,131,5.5,53
150000000,1513528810,1363528810,418.708552,124,6.5,28
200000000,1108561013,908561013,93.004993,143,6.9,28
200000000,783766341,583766341,35.149586,127,6.7,28
200000000,1215439994,1015439994,77.68208,130,6.8,28
200000000,1025491110,825491110,78.530105,108,6.4,10751
210000000,459359555,249359555,3.857526,104,6.3,12
200000000,743559607,543559607,89.186492,104,7,16
150000000,836297228,686297228,21.939663,150,6,878
210000000,1091405097,881405097,116.840296,165,5.8,878
200000000,491868548,291868548,46.985445,130,5.7,14
200000000,705717432,505717432,89.270217,142,6.5,28
170000000,400062763,230062763,73.79505,125,6.3,12
200000000,559852396,359852396,49.98659,106,5.8,16
200000000,219851172,19851172,51.872839,114,5.1,12
200000000,1066969703,866969703,59.995418,103,7.6,16
200000000,371353001,171353001,71.862892,115,5.9,28
190000000,1506249360,1316249360,102.322217,137,7.3,28
200000000,531865000,331865000,81.834855,116,6.7,28
250000000,747862775,497862775,118.078691,131,7.5,28
190000000,467365246,277365246,78.291018,132,7.4,28
195000000,197687603,2687603,43.349855,114,5.5,28
105000000,351040419,246040419,61.196071,143,7.3,18
150000000,335154643,185154643,62.169881,116,6.2,12
180000000,407602906,227602906,56.523205,131,6.7,28
195000000,1123746996,928746996,28.529607,154,6.1,28
185000000,786636033,601636033,75.674458,122,5.7,12
175000000,331926147,156926147,51.692953,93,6.6,12
185000000,538983207,353983207,125.114374,93,6.7,16
185000000,343471816,158471816,65.352913,122,6.6,28
180000000,521311860,341311860,66.390712,98,7.8,16
140000000,258022233,118022233,22.57178,91,6.1,28
200000000,769653595,569653595,45.274225,158,5.6,28
200000000,325233863,125233863,39.744242,96,6.6,16
176000003,183987723,7987720,85.36908,124,5.2,878
180000000,356743061,176743061,42.741719,109,5.5,28
180000000,748806957,568806957,67.391328,143,6.7,12
178000000,543934787,365934787,139.272042,144,6.4,878
185000000,1004558444,819558444,187.322927,152,8.2,18
175000000,735099082,560099082,92.201962,96,7.7,16
175000000,381509870,206509870,36.167578,94,6,16
140000000,585174222,445174222,120.725053,126,7.4,28
170000000,185770160,15770160,32.319043,126,7,12
170000000,222104681,52104681,40.748915,106,5.1,28
145000000,401128639,256128639,60.034162,112,5.2,12
175000000,745000000,570000000,90.23792,123,5.9,28
175000000,173000000,-2000000,27.082182,96,5.3,14
178000000,370541256,192541256,79.456485,113,7.6,28
175000000,264218220,89218220,44.640292,135,5.9,12
175000000,302469017,127469017,32.852443,118,5.6,12
175000000,857611174,682611174,128.655964,94,8,18
175000000,966550600,791550600,94.199316,106,6.7,10751
200000000,623933331,423933331,77.300194,124,6.6,12
170000000,396600000,226600000,77.178973,127,5.8,12
180000000,758539785,578539785,110.620647,97,7,14
170000000,710644566,540644566,243.791743,130,7.3,878
27000000,0,-27000000,2.418535,109,4.8,28
175000000,150962475,-24037525,41.796339,119,5.9,18
170000000,714766572,544766572,72.225265,136,7.6,28
165000000,752600867,587600867,44.041186,93,6,35
190000000,209154322,19154322,130.311355,130,6.2,12
165000000,652105443,487105443,203.73459,102,7.8,12
165000000,471222889,306222889,62.341073,108,7.1,10751
165000000,305875730,140875730,47.323228,100,6.4,12
165000000,389681935,224681935,48.775723,120,4.9,28
165000000,494878759,329878759,67.263269,98,7.5,14
200000000,435000000,235000000,69.405188,109,5.9,28
170000000,773328629,603328629,481.098624,121,7.9,28
165000000,675120017,510120017,724.247784,169,8.1,12
160000000,825532764,665532764,167.58371,148,8.1,28
15000000,77000000,62000000,9.476999,120,6.5,28
250000000,1021103568,771103568,108.849621,169,7,12
38000000,207283925,169283925,6.909942,106,6.6,28
150000000,333932083,183932083,60.269279,166,7.3,14
160000000,353624124,193624124,3.195174,132,7.1,28
160000000,653428261,493428261,127.284427,137,6.6,28
150000000,215283742,65283742,35.580815,109,5.8,14
160000000,181674817,21674817,21.133748,99,5.5,12
170000000,299370084,129370084,56.268916,113,6.5,14
160000000,798958165,638958165,42.986467,93,6,14
160000000,433677183,273677183,63.148529,123,6.3,28
155000000,440603537,285603537,202.042635,126,5.8,878
155000000,415686217,260686217,49.661984,113,6.2,12
140000000,449220945,309220945,34.20669,183,6.6,36
150000000,709709780,559709780,25.468493,144,6.6,12
155000000,167298192,12298192,39.019229,175,5.6,10752
150000000,938212738,788212738,78.144395,138,7.4,12
150000000,895921036,745921036,101.250416,157,7.5,12
150000000,624029371,474029371,56.758411,92,6.2,14
150000000,585349010,435349010,70.867401,101,6.9,18
150000000,474968763,324968763,53.905592,115,6.7,12
150000000,623722818,473722818,65.677399,111,7.5,16
150000000,374218673,224218673,115.040024,140,7.5,28
150000000,603900354,453900354,44.141021,89,6.2,10751
150000000,413106170,263106170,81.781591,105,5.9,12
150000000,373062864,223062864,5.954334,107,6.2,12
150000000,424988211,274988211,73.313918,129,6.4,12
150000000,1274219009,1124219009,165.125366,102,7.3,16
150000000,738599701,588599701,70.78591,138,6.7,12
170000000,644571402,474571402,99.499595,112,6.8,28
150000000,378858340,228858340,434.278564,120,7.2,28
150000000,356613439,206613439,67.447636,138,6.5,53
150000000,449326618,299326618,86.493424,115,6.6,12
150000000,309979994,159979994,41.845878,98,6.3,16
150000000,292817841,142817841,26.710398,88,5.1,14
150000000,301000000,151000000,44.927635,99,5.5,12
150000000,245527149,95527149,50.306728,113,5.7,35
150000000,682330139,532330139,114.522237,131,7.1,28
150000000,0,-150000000,21.214571,102,5.5,18
150000000,287594577,137594577,29.332905,91,5.7,10751
150000000,665692281,515692281,51.247321,91,6.7,16
150000000,318502923,168502923,33.769336,103,4.7,28
150000000,397850012,247850012,63.079003,126,6.5,12
150000000,205366737,55366737,39.004588,131,6.4,28
150000000,38992758,-111007242,12.362599,88,5.5,12
149000000,64459316,-84540684,22.550135,85,6,12
150000000,128388320,-21611680,48.03528,111,5.9,12
145000000,272912430,127912430,38.73494,92,6.7,16
175000000,497409852,322409852,66.803149,163,6.9,12
145000000,746921274,601921274,44.989192,93,6.4,16
140000000,431971116,291971116,54.159392,133,5.8,12
144000000,229147509,85147509,66.21806,116,5.3,28
140000000,553799566,413799566,58.485967,151,6.4,28
140000000,441818803,301818803,91.332849,88,6,28
70000000,195735876,125735876,35.601665,115,5.5,12
145000000,521170825,376170825,56.747978,95,6.7,28
145000000,694713380,549713380,77.77477,133,6.8,28
145000000,306941670,161941670,61.788035,97,7.1,14
100000000,202026112,102026112,25.159168,90,5.9,35
140000000,456758981,316758981,52.341226,154,7.3,18
140000000,268031828,128031828,101.599427,150,5.6,12
150000000,385680446,235680446,73.616808,127,7.4,878
139000000,821708551,682708551,82.502566,121,6.8,14
145000000,609123048,464123048,100.21391,102,7.6,14
140000000,150680864,10680864,56.257249,127,5.3,14
135000000,76932943,-58067057,17.88953,121,4.9,28
130000000,185258983,55258983,64.798873,163,7,28
140000000,285444603,145444603,24.855701,127,6.3,28
137000000,245360480,108360480,34.981698,138,5.3,18
130000000,371876278,241876278,59.325589,110,5.4,12
130000000,119269486,-10730514,21.605568,124,5.7,28
137000000,85131830,-51868170,26.074908,106,5.9,12
140000000,370569774,230569774,74.506246,124,6.6,28
135000000,361832400,226832400,39.604363,128,6,12
150000000,212011111,62011111,36.973031,138,6.9,12
120000000,829000000,709000000,99.687084,115,6.1,12
130000000,150406466,20406466,17.7735,100,5.8,16
150000000,163712074,13712074,62.898336,114,6.1,878
140000000,183345589,43345589,44.19092,120,6,12
135000000,532950503,397950503,100.635882,156,7.3,37
135000000,282570682,147570682,44.765377,96,6.1,16
135000000,245724603,110724603,29.91353,107,6.6,16
132000000,373552094,241552094,84.366984,92,6.5,10751
70000000,442824138,372824138,45.381501,115,7.3,28
130000000,631744560,501744560,84.689648,90,6.9,12
130000000,519311965,389311965,120.09361,117,7,878
130000000,847423452,717423452,76.310119,146,7.4,12
135000000,368871007,233871007,63.473086,94,6.8,14
132000000,591739379,459739379,48.572726,116,6.2,12
130000000,273339556,143339556,38.068736,147,6.3,12
130000000,554987477,424987477,20.678787,90,6.4,28
110000000,293329073,183329073,48.829437,100,6.2,28
125000000,362637473,237637473,46.115758,139,5.6,18
130000000,371940071,241940071,89.938296,107,6.7,12
130000000,789804554,659804554,79.679601,141,7.7,12
130000000,49554002,-80445998,28.840997,165,6.3,18
130000000,243843127,113843127,42.840582,100,5,878
127500000,354248063,226748063,26.548594,82,6.2,16
127000000,349424282,222424282,115.597753,97,6.1,12
130000000,321887208,191887208,68.757242,95,6.7,16
125000000,976475550,851475550,109.984351,152,7.5,12
130000000,61648500,-68351500,39.448066,96,5.4,14
140000000,655011224,515011224,271.972889,143,7.5,12
125000000,752100229,627100229,206.227151,123,6.6,878
125000000,767820459,642820459,45.313197,149,6.5,53
103000000,500188435,397188435,42.40024,102,6.3,16
110000000,407711549,297711549,2.871739,133,6.8,12
125000000,626137675,501137675,7.255718,130,7.1,28
125000000,334615000,209615000,81.499621,129,7,12
125000000,232713139,107713139,47.686442,106,5.6,12
65000000,261317921,196317921,43.129703,113,7.1,28
160000000,61698899,-98301101,27.220157,102,6.4,12
130000000,276572938,146572938,90.33681,120,6,28
125000000,238207122,113207122,50.073575,125,4.2,28
123000000,345141403,222141403,45.419668,104,6.2,10751
125000000,544272402,419272402,41.380094,124,6.2,28
125000000,546388105,421388105,54.931334,123,5.9,12
120000000,325756637,205756637,25.752118,130,6.2,18
130000000,289047763,159047763,60.810723,92,5.4,12
120000000,609016565,489016565,51.328145,127,7.2,12
110000000,228738393,118738393,46.834704,114,5.2,53
120000000,415484914,295484914,62.641286,123,5.9,28
120000000,259175788,139175788,33.616115,106,5.2,28
130000000,403170142,273170142,68.889395,124,6.3,878
120000000,169956806,49956806,27.990284,78,5.4,10751
115000000,286140700,171140700,67.33767,109,6.4,878
105000000,115772733,10772733,27.835436,119,6.3,28
120000000,242688965,122688965,66.757869,102,5.7,28
120000000,93945766,-26054234,17.060695,135,5.7,28
120000000,48668907,-71331093,11.137655,121,4.9,35
117000000,261930431,144930431,44.906918,109,5.9,28
120000000,286168572,166168572,67.698004,124,6.4,28
113000000,850000000,737000000,44.108427,140,7.1,878
120000000,649398328,529398328,43.987061,142,6.4,12
115000000,562816256,447816256,106.815545,92,7.5,16
120000000,415440673,295440673,15.953444,126,6.3,28
115000000,924317558,809317558,54.035265,136,6.3,12
135000000,585178928,450178928,64.183321,98,6.8,12
97250400,132900000,35649600,20.344364,116,5,14
115000000,77628265,-37371735,18.714197,134,5.8,18
115000000,164602163,49602163,60.467984,114,6,28
125000000,477200000,352200000,143.350376,101,5.8,878
105000000,716392705,611392705,110.153618,91,7.3,878
116000000,178127760,62127760,16.90444,108,5.7,28
135000000,245623848,110623848,39.873791,112,5.8,14
120000000,167977596,47977596,38.126095,100,4.4,28
110000000,574480841,464480841,48.780039,108,6.3,28
110000000,470490832,360490832,100.412364,114,6,28
110000000,333011068,223011068,42.887121,119,6,12
110000000,215294342,105294342,23.657284,165,6.8,18
110000000,362744280,252744280,76.840712,125,6.4,53
110000000,478207520,368207520,44.635452,120,6.5,28
110000000,295238201,185238201,103.718387,119,6.2,12
116000000,102000000,-14000000,45.616098,170,7,18
112000000,237382724,125382724,22.845143,85,4.9,35
120000000,227817248,107817248,31.703608,119,5.5,28
110000000,337580051,227580051,71.510596,102,6.1,28
110000000,563749323,453749323,36.65422,103,5.5,16
110000000,103951461,-6048539,19.625972,76,5.7,16
110000000,179246868,69246868,86.105615,121,5.9,12
110000000,299268508,189268508,37.195046,127,6.6,28
105000000,347434178,242434178,32.473628,105,5.5,14
160000000,164508066,4508066,23.336875,121,4.1,28
110000000,125537191,15537191,45.94834,114,6.6,878
110000000,383531464,273531464,48.93337,128,6.4,28
93000000,871368364,778368364,138.049577,178,8,12
110000000,72178895,-37821105,22.643776,120,5.7,28
107000000,87713825,-19286175,18.866672,157,6.7,18
0,0,0,18.251129,82,4.9,35
120000000,347234916,227234916,95.914473,115,6.7,28
130000000,211643158,81643158,44.490453,144,6.6,18
133000000,300135367,167135367,30.475297,84,5.8,16
105000000,267045765,162045765,62.479574,97,6.7,10749
108000000,630161890,522161890,167.93287,141,7.6,18
126000000,162949164,36949164,37.68056,136,6.5,28
90000000,10372291,-79627709,1.004579,104,3.7,35
90000000,237202299,147202299,52.995628,118,6.1,28
103000000,457640427,354640427,95.301296,155,7.9,28
102000000,358372926,256372926,65.948959,145,7.1,28
100000000,876688482,776688482,132.397737,161,7.4,12
150000000,599045960,449045960,88.935165,144,7.3,12
100000000,362211740,262211740,51.188633,119,5.6,53
100000000,520000000,420000000,101.74155,137,7.7,28
80000000,214104620,134104620,33.691694,140,6.5,36
100000000,266465037,166465037,42.361215,157,7.4,18
115000000,378882411,263882411,38.729418,141,6.8,28
100000000,150166126,50166126,40.597856,106,6.2,53
100000000,310650585,210650585,32.389353,98,5.4,35
100000000,170432927,70432927,24.399642,107,6.1,28
100000000,242295562,142295562,24.507987,115,5.6,28
100000000,425368238,325368238,82.121691,165,7.8,18
100000000,100138851,138851,46.727941,91,6.8,18
100000000,169327687,69327687,51.113717,78,7.2,12
100000000,312573423,212573423,53.732892,103,6.1,28
100000000,347451894,247451894,58.849256,131,6.4,12
100000000,249288105,149288105,30.863434,104,4.9,14
100000000,100086793,86793,31.586215,101,6.4,10751
100000000,268426634,168426634,36.711378,102,6.4,16
100000000,278731369,178731369,41.426678,103,6,28
100000000,211989043,111989043,20.652943,121,5.5,28
100000000,170877916,70877916,52.792678,143,7.3,18
100000000,392000694,292000694,95.007934,180,7.9,80
100000000,336529144,236529144,48.205606,121,5.2,28
105000000,121214377,16214377,58.782359,129,6.7,12
102000000,130482868,28482868,73.872343,172,6.6,18
80000000,140073390,60073390,37.321848,97,6.5,16
100000000,82102379,-17897621,32.271938,104,4.2,28
100000000,243400000,143400000,76.842247,99,5.6,28
140000000,109578115,-30421885,38.924136,95,7.2,12
100000000,68688831,-31311169,19.38841,102,5.3,12
90000000,206172544,116172544,61.025639,127,6.1,28
105000000,133718711,28718711,33.507289,114,5.5,28
84000000,0,-84000000,17.815595,94,3.6,14
100000000,93820758,-6179242,50.767332,122,6.5,53
100000000,7103973,-92896027,12.092241,95,4.4,28
100000000,94882889,-5117111,30.254021,115,6.4,10752
99000000,246233113,147233113,34.308098,88,6.5,16
10000000,13835130,3835130,3.091077,110,7.1,80
98000000,433013274,335013274,41.862983,130,6,12
100000000,193772504,93772504,46.160048,167,7.1,18
94000000,95311434,1311434,12.516546,145,7.1,18
85000000,149044513,64044513,23.230851,85,5.9,16
90000000,102000000,12000000,19.224754,93,5.4,28
92000000,172989651,80989651,44.455166,144,7.2,28
0,104907746,104907746,16.460356,85,5.6,35
90000000,263920180,173920180,109.528572,126,7.3,12
100000000,288347692,188347692,18.325897,146,5.4,35
95000000,76432727,-18567273,37.054554,89,7,12
95000000,877244782,782244782,65.229868,88,6.2,16
95000000,543514353,448514353,101.187052,105,6.7,10749
65000000,93525586,28525586,29.257137,136,6.6,14
94000000,940335536,846335536,85.688789,100,7.6,16
94000000,1118888979,1024888979,123.630332,201,8.1,12
79000000,926287400,847287400,106.914973,179,8,12
95000000,114178613,19178613,63.628459,102,5.2,12
115000000,274703340,159703340,41.498631,100,5.7,12
100000000,103039258,3039258,58.991388,119,5.9,53
93000000,368780809,275780809,1.859364,92,5.7,12
93000000,482860185,389860185,138.433168,105,7,53
90000000,162839667,72839667,21.436682,95,6.3,12
92000000,304654182,212654182,65.402595,98,5.2,28
145000000,25819961,-119180039,10.660441,137,5.8,37
92000000,631442092,539442092,77.817571,115,7.4,28
98000000,10017322,-87982678,7.029308,119,5.7,28
95000000,226497209,131497209,61.121717,118,6,12
90000000,589390539,499390539,104.121555,98,6.9,28
90000000,497366869,407366869,73.575118,92,7.3,16
100000000,167805466,67805466,37.698465,98,6.3,28
90000000,347325802,257325802,35.814765,90,6.4,28
100000000,155464351,55464351,15.835672,130,6.3,18
100000000,242988466,142988466,46.781182,90,6.5,16
90000000,886686817,796686817,69.457898,94,6.5,16
90000000,188133322,98133322,43.348022,114,7,12
92000000,264105545,172105545,40.20395,98,5.6,28
90000000,289847354,199847354,63.429157,151,7.9,18
90000000,304320254,214320254,67.427755,88,7.6,16
92000000,188072649,96072649,43.192048,107,6.5,28
90000000,232617430,142617430,47.651083,158,7.2,53
90000000,366101666,276101666,51.881077,128,6.9,28
90000000,524028679,434028679,57.834787,128,7,28
100000000,94061311,-5938689,29.608322,125,5.3,18
120000000,186053725,66053725,51.548589,95,6.7,16
0,233755553,233755553,27.867368,92,5.8,12
75000000,200276000,125276000,38.832842,121,6.7,18
90000000,201596308,111596308,40.597344,113,5.5,35
88000000,243637091,155637091,140.849495,105,5.6,28
100000000,235926552,135926552,34.035114,146,6.8,18
90000000,182290266,92290266,16.302378,99,5.2,53
90000000,171120329,81120329,55.249434,150,7.2,18
95000000,190213455,95213455,28.200874,112,5.6,28
80000000,162944923,82944923,18.69984,128,6.2,80
90000000,174578751,84578751,40.262261,106,5.9,12
95000000,156505388,61505388,56.811056,117,5.5,28
90000000,334901337,244901337,51.535701,129,6.7,28
68000000,118063304,50063304,20.913852,116,5.9,53
92000000,143049560,51049560,27.166757,126,6.8,28
90000000,60874615,-29125385,16.058284,114,5.7,878
90000000,484635760,394635760,46.200042,96,6.5,16
100000000,93700000,-6300000,24.939295,131,6.9,35
90000000,0,-90000000,19.836124,104,5.2,878
90000000,140807547,50807547,15.350451,107,5.9,80
100000000,35168966,-64831034,15.625949,138,6.1,18
20000000,79114085,59114085,31.802807,129,6.6,12
88000000,108539911,20539911,24.100863,144,7.3,10749
90000000,16178959,-73821041,3.593349,110,5.4,14
87000000,148336445,61336445,14.824166,141,6.7,18
92000000,494471524,402471524,32.079995,113,6.1,28
90000000,429632142,339632142,57.739713,143,7.5,12
100000000,384335608,284335608,37.272385,108,5.9,16
75000000,288500217,213500217,53.213931,108,7.2,28
85000000,315156409,230156409,36.38795,124,6.2,28
85000000,450717150,365717150,60.929352,116,7.2,53
75000000,132274484,57274484,36.605246,110,5.6,12
85000000,358375603,273375603,56.257411,91,6.8,16
85000000,340487652,255487652,29.21998,107,6.6,35
85000000,208076205,123076205,34.773106,115,6.3,28
85000000,183611771,98611771,9.895061,100,5.1,35
75000000,152930623,77930623,36.743324,104,5.8,28
85000000,194168700,109168700,44.967453,136,6.7,35
90000000,250649836,160649836,41.207568,132,6.7,28
85000000,219103655,134103655,16.479851,121,6.2,35
85000000,311312624,226312624,42.069993,122,6.5,80
85000000,197309027,112309027,26.61951,83,6.1,12
85000000,288747895,203747895,80.316463,139,6.9,12
68000000,96976270,28976270,41.273567,131,7.2,10752
85000000,80916492,-4083508,24.107835,104,6.4,12
85000000,137298489,52298489,32.044191,130,6.1,12
85000000,162242962,77242962,16.595874,145,7.3,18
85000000,158468292,73468292,8.282876,104,6.1,28
0,0,0,19.83683,97,6.7,18
90000000,142940100,52940100,36.069611,178,6.9,14
85000000,78382433,-6617567,18.827753,108,5.5,28
0,37823676,37823676,5.159407,123,7.3,18
85000000,183018522,98018522,48.126297,106,5.5,12
60000000,47664559,-12335441,38.885195,112,7.2,28
60000000,74208267,14208267,29.211255,136,5.4,28
84000000,123307945,39307945,17.783361,106,4.7,14
84000000,275650703,191650703,31.435539,88,5.4,9648
50000000,41037742,-8962258,57.673932,95,6.6,28
82500000,237681299,155181299,41.176631,107,6,35
8000000,21028755,13028755,13.661289,120,6.7,27
85000000,112483764,27483764,11.77398,82,4.9,35
85000000,222231186,137231186,21.218,88,5.9,12
85000000,160388063,75388063,58.57976,120,6.5,12
65000000,84785914,19785914,51.970905,157,7.3,80
82000000,96085477,14085477,18.447479,123,5.7,878
80000000,484572835,404572835,109.684788,101,6.4,14
80000000,274470394,194470394,77.580661,103,6,53
80000000,457696359,377696359,75.290998,110,6.7,12
75000000,691210692,616210692,68.550698,142,6.9,878
80000000,254455986,174455986,58.040149,102,6.2,35
80000000,280000000,200000000,59.113174,126,6.6,28
80000000,343397247,263397247,36.32705,83,6.3,35
80000000,145771527,65771527,55.659988,85,7.1,16
85000000,144000000,59000000,14.132583,97,5.8,35
75000000,140464664,65464664,34.070054,120,5.9,28
84000000,0,-84000000,44.34333,116,6.4,28
82000000,190320568,108320568,26.065735,113,6.2,35
75000000,342695435,267695435,23.473004,87,5.4,35
80000000,246984278,166984278,45.589568,100,5.8,35
80000000,230685453,150685453,23.496054,110,6,28
80000000,266728738,186728738,16.939441,128,6.3,18
80000000,294804195,214804195,81.914696,138,7.8,18
80000000,163733697,83733697,19.500893,88,5.3,35
75000000,260696994,185696994,29.558157,91,6,16
80000000,245676146,165676146,46.075037,138,6.8,28
80000000,212874442,132874442,23.531721,99,5.9,14
80000000,181001478,101001478,49.078546,117,7.3,53
80000000,214918407,134918407,37.02665,117,6.3,10749
75000000,224012234,149012234,45.154631,115,6.5,28
80000000,178066569,98066569,46.887983,118,6.3,9648
79000000,173013509,94013509,24.598479,154,6.7,18
80000000,157107755,77107755,32.363538,118,6.6,28
80000000,177977226,97977226,11.50396,93,5.3,35
80000000,91188905,11188905,19.375768,113,5.2,27
80000000,250200000,170200000,36.125715,88,6.5,16
0,0,0,25.450534,93,5.6,28
80000000,233093859,153093859,41.890722,104,5.2,18
75000000,136982834,61982834,22.179658,135,6.5,28
68000000,211817906,143817906,139.575085,135,7.4,10752
70000000,164000000,94000000,18.264635,98,5.6,28
80000000,201584141,121584141,11.187696,80,5.2,35
80000000,122563539,42563539,41.670544,83,7.4,37
80000000,169852759,89852759,27.46264,102,5.3,35
80000000,136159423,56159423,17.455024,130,5,12
80000000,96105964,16105964,21.394281,129,6.2,18
0,0,0,0.605645,117,8,10749
80000000,473226958,393226958,61.692197,89,6.7,16
80000000,90874570,10874570,14.530946,74,7,16
80000000,123729176,43729176,25.978555,96,5.8,878
90000000,0,-90000000,6.643778,114,5.9,28
102000000,147080413,45080413,36.788745,99,6.1,28
75000000,142400065,67400065,31.054334,129,5.9,28
85000000,71485043,-13514957,21.891078,113,6.8,18
85000000,0,-85000000,18.335992,90,5.2,35
88000000,105316267,17316267,40.138009,118,5.6,12
70000000,101371017,31371017,44.090535,106,6.1,35
0,0,0,3.300061,81,6.4,9648
0,43312294,43312294,20.632673,117,6.7,28
80000000,122444772,42444772,36.664991,89,5.9,28
80000000,34566746,-45433254,18.26121,145,6.9,18
80000000,159212469,79212469,16.681269,115,5.8,28
80000000,126546518,46546518,10.088006,87,5.2,16
44000000,21400000,-22600000,7.89147,118,3,28
80000000,68514844,-11485156,16.715631,90,5.6,16
80000000,53825515,-26174485,9.357734,112,5.1,18
80000000,19480739,-60519261,11.22268,116,5.4,28
80000000,17626234,-62373766,14.564667,177,6.1,18
90000000,69131860,-20868140,11.356079,92,5.2,12
90000000,146936910,56936910,52.612025,106,5.7,14
80000000,33463969,-46536031,13.800656,106,5.4,53
86000000,107944236,21944236,27.097932,94,6,12
0,19406406,19406406,10.706613,84,7.3,99
80000000,5989640,-74010360,7.342892,110,4.8,53
130000000,117831631,-12168369,50.561849,105,5.2,28
8000000,0,-8000000,0.719996,89,5.3,35
60000000,313542341,253542341,59.248437,135,7.7,18
45000000,788241776,743241776,90.457886,89,8,10751
79000000,355692760,276692760,40.723459,94,5.8,12
78000000,248384621,170384621,41.247402,95,6.4,16
78000000,209196298,131196298,10.083905,124,6.7,80
100000000,108103450,8103450,16.759252,136,6.5,37
79000000,149673788,70673788,22.132418,91,4.1,35
76000000,236350661,160350661,10.520961,107,6.2,28
64000000,97571250,33571250,35.384423,92,7.6,12
80000000,15071514,-64928486,15.673154,99,5.7,878
76000000,35134820,-40865180,8.981427,88,3.9,28
75000000,875958308,800958308,31.482872,87,5.9,16
78000000,179265204,101265204,47.436675,110,5.7,14
76000000,970761885,894761885,136.886704,98,7,16
75000000,816969268,741969268,60.442593,145,6.7,28
73000000,229074524,156074524,2.502487,129,6.2,12
75000000,532680671,457680671,48.110909,86,6.6,10751
76000000,69959751,-6040249,35.387874,109,7.4,18
75000000,296339527,221339527,4.66891,104,6.8,12
75000000,258270008,183270008,73.82289,110,6.4,28
75000000,335062621,260062621,51.469576,136,6.9,28
80000000,660940780,580940780,85.115058,91,6.5,16
75000000,196482882,121482882,61.437586,99,6.6,35
50000000,90450008,40450008,31.160542,117,6.5,10751
80000000,78000586,-1999414,15.761384,114,4.7,27
75000000,0,-75000000,17.561955,78,4.3,28
75000000,117698894,42698894,71.124686,115,7.3,53
80000000,271430189,191430189,38.864027,102,6,35
60000000,219417255,159417255,57.753914,128,7,35
35000000,73034460,38034460,13.25753,100,5.7,35
75000000,215663859,140663859,13.318744,124,5.9,28
75000000,119000410,44000410,18.70031,102,6.5,35
75000000,367275019,292275019,47.094369,90,5.8,16
70000000,154937680,84937680,14.486311,134,6.6,18
53000000,95226116,42226116,18.61472,118,5.4,35
70000000,130358911,60358911,29.035222,164,6.9,18
70000000,85632458,15632458,27.055085,121,6.4,28
75000000,98159963,23159963,23.004607,100,5.7,28
75000000,108145109,33145109,48.744209,116,7.1,35
80000000,55041367,-24958633,14.209329,130,5.8,35
75000000,140175006,65175006,36.368839,91,6.3,16
75000000,67631903,-7368097,24.353302,123,6.2,28
55000000,127600435,72600435,19.143321,134,5.9,28
75000000,0,-75000000,13.327372,148,6.4,18
75000000,226904017,151904017,37.917002,110,5.7,14
52000000,77944725,25944725,23.663713,113,6.2,9648
75000000,36754634,-38245366,14.44381,94,6.3,16
75000000,51142659,-23857341,10.605084,116,5,28
75000000,14567883,-60432117,11.873856,99,6.1,28
0,5802422,5802422,12.708963,84,5.8,28
75000000,5409517,-69590483,8.098369,93,4.3,12
45000000,21009180,-23990820,20.374308,113,5.7,28
75000000,248118121,173118121,42.006908,106,6.9,878
74000000,1156730962,1082730962,875.581305,91,6.4,10751
82000000,89792502,7792502,39.127082,110,5.9,28
73000000,103891409,30891409,20.790703,98,5.8,80
75000000,13100000,-61900000,18.65988,134,5.8,878
73000000,349779543,276779543,45.720894,97,5.9,10751
70000000,111231041,41231041,21.789615,112,5.4,10749
75000000,61458982,-13541018,20.199057,146,5.7,35
70000000,86658558,16658558,26.123705,110,6.5,53
72500000,162966177,90466177,12.599836,116,6.2,35
70000000,176104344,106104344,13.543053,87,4.9,35
72000000,210000000,138000000,60.722162,177,7.7,28
72000000,96889998,24889998,32.227223,125,6.6,18
75000000,527068851,452068851,46.875375,87,6.9,16
72000000,37317558,-34682442,11.215702,152,6.6,18
94000000,54744738,-39255262,8.468586,116,4.5,28
74500000,62172050,-12327950,8.884318,109,6.9,12
60000000,256697520,196697520,27.491891,108,6.2,18
71000000,294456605,223456605,21.462935,85,5.4,35
72000000,408247917,336247917,28.848187,106,6.4,18
150000000,919838758,769838758,47.320801,93,6.7,12
120000000,461983149,341983149,82.643036,117,6.6,16
70000000,309457509,239457509,20.230535,116,5.7,35
70000000,277448382,207448382,46.217769,124,5.8,28
74000000,311594032,237594032,36.952268,93,5.8,16
80000000,309492681,229492681,16.411345,117,6.4,28
70000000,319131050,249131050,72.595961,153,7.9,18
70000000,300854823,230854823,33.648404,144,6.6,12
70000000,240031094,170031094,57.69847,124,6.6,28
80000000,116643346,36643346,34.052253,117,5.8,28
68000000,203388341,135388341,27.299301,136,6.5,18
75000000,42285169,-32714831,20.219385,110,5.3,18
70000000,171183863,101183863,42.957216,101,5.5,12
75000000,443140005,368140005,29.412262,88,5.4,35
75000000,114660784,39660784,19.708731,138,6.7,28
70000000,161025640,91025640,59.428223,120,6.2,28
70000000,118000000,48000000,19.711951,103,6.3,878
70000000,202466756,132466756,49.199234,116,5.5,28
70000000,122919055,52919055,46.199482,125,7.6,12
0,0,0,13.758526,125,6,14
66000000,177584879,111584879,29.505574,146,7,18
70000000,154984035,84984035,43.873266,118,5.8,10752
70000000,90000098,20000098,24.961625,139,7.1,12
70000000,134748021,64748021,23.25645,133,5.8,18
70000000,215529201,145529201,64.457947,92,6.2,27
70000000,116672912,46672912,20.089933,116,6,18
70000000,135560026,65560026,48.032734,127,7.1,12
70000000,131457682,61457682,16.92991,136,7,12
70000000,67112664,-2887336,14.780634,111,5.2,35
70000000,65977295,-4022705,14.086292,116,5.4,28
60000000,55987321,-4012679,29.261348,105,5,12
70000000,33561137,-36438863,13.267631,97,5.2,28
70000000,160112671,90112671,58.401204,88,6.1,14
75000000,59418613,-15581387,23.515938,123,6,35
70000000,32287044,-37712956,14.244518,125,5.9,18
66000000,57777106,-8222894,29.501489,116,6.1,28
0,0,0,9.306253,98,3.4,28
70000000,19924033,-50075967,8.37378,91,4.3,28
70000000,19870567,-50129433,10.930537,97,5.5,53
75000000,13596911,-61403089,10.54544,95,5.9,12
70000000,18662027,-51337973,6.682006,88,5.9,16
70000000,17752940,-52247060,46.832372,133,5.1,80
70000000,57958696,-12041304,24.664776,107,5.7,9648
70000000,38629478,-31370522,13.483387,114,4.6,80
50000000,122915111,72915111,44.478043,115,6.7,28
70000000,61279452,-8720548,25.020428,99,4.4,28
68000000,193000000,125000000,22.392544,124,5.9,53
68000000,698491347,630491347,107.069763,124,5.8,12
68000000,71069884,3069884,22.572323,124,6.7,28
69000000,543513985,474513985,113.858273,95,7.1,16
60000000,35431113,-24568887,10.004564,103,5.4,28
68000000,217022588,149022588,68.734513,115,6.2,35
70000000,39041505,-30958495,18.888806,127,6.9,12
68000000,29762011,-38237989,12.948627,121,5.7,12
36000000,83160734,47160734,27.11589,105,5.4,35
90000000,60289912,-29710088,26.153669,157,7.3,18
80000000,52099090,-27900910,28.223664,114,6.3,28
70000000,113280098,43280098,37.507136,128,6.5,28
69000000,86387857,17387857,11.023691,114,5.5,35
69000000,112265139,43265139,38.634767,94,5.5,28
66000000,212404396,146404396,25.877794,112,6,10749
66000000,189198313,123198313,18.59991,121,6.6,9648
67000000,25303038,-41696962,12.282911,102,5,28
70000000,481840909,411840909,76.041867,169,7.9,18
66000000,203277636,137277636,54.81489,130,6.1,28
70000000,374111707,304111707,31.39165,127,6.1,35
59000000,383257136,324257136,99.561972,81,7.1,16
68000000,75715436,7715436,26.792794,136,5.3,18
65000000,275293450,210293450,36.307296,149,6.7,36
63000000,463517383,400517383,104.309993,136,7.9,28
52000000,355237933,303237933,68.140214,140,7.3,18
65000000,172855065,107855065,14.646884,104,5.5,14
61000000,441809770,380809770,48.356214,157,7.1,18
65000000,250821495,185821495,28.540267,119,6.3,35
65000000,128107642,63107642,22.977983,98,6.5,35
95000000,250288523,155288523,31.086791,136,6.3,28
65000000,211780824,146780824,43.865294,95,6.2,35
65000000,163442937,98442937,43.055253,137,7.3,18
65000000,128884132,63884132,15.772081,130,6.3,28
70000000,255000211,185000211,26.19909,112,6.1,28
50000000,150270147,100270147,22.769108,108,5.7,28
65000000,69700000,4700000,18.281798,104,6,14
63000000,162945894,99945894,24.697533,128,5.9,18
65000000,0,-65000000,19.718544,117,6.5,18
65000000,179379533,114379533,31.349143,83,5.9,35
65000000,162091208,97091208,27.870312,159,7.1,9648
65000000,133821816,68821816,33.439187,119,6,35
50100000,153962963,103862963,59.634029,105,6.7,10749
65000000,156974557,91974557,38.994297,103,5.9,28
65000000,128905366,63905366,49.660055,123,5.7,878
4200000,38376497,34176497,11.743085,114,6.4,28
65000000,0,-65000000,9.110247,143,6.1,35
65000000,240159255,175159255,6.227675,95,5.6,28
45000000,73762516,28762516,42.57877,105,6,28
65000000,89456761,24456761,15.858629,120,6.5,80
65000000,0,-65000000,14.866901,135,6,28
65000000,64321501,-678499,15.194239,101,6.1,10751
63000000,100853753,37853753,146.757391,139,8.3,18
65000000,43545364,-21454636,8.629665,124,6.7,18
65000000,17218080,-47781920,16.803457,100,5.4,28
65000000,0,-65000000,2.952595,105,4.9,28
65000000,71154592,6154592,31.324734,92,5,27
50000000,42093706,-7906294,20.415572,130,6.7,80
43000000,56681566,13681566,28.613892,97,4.8,28
65000000,39407616,-25592384,85.428395,102,6.3,80
64000000,74608570,10608570,4.137237,133,5.3,18
55000000,203427584,148427584,60.246978,121,6.7,12
50000000,132180323,82180323,42.551902,147,7.1,80
63000000,296655431,233655431,40.137264,94,5.9,35
65000000,44091067,-20908933,24.857079,94,6.1,16
63000000,920100000,857100000,40.413191,127,7.6,12
63000000,25052000,-37948000,13.859307,191,6.5,18
62000000,215887717,153887717,18.832471,141,6.4,28
65000000,121545703,56545703,9.568884,127,5.9,28
64000000,101595121,37595121,12.421504,98,5.3,35
62000000,127666415,65666415,18.096884,116,6.1,28
62000000,107879496,45879496,11.056763,106,6.5,35
62000000,41819064,-20180936,13.218008,87,4.3,35
62000000,18720175,-43279825,11.262655,125,5.8,28
44000000,155760117,111760117,68.717016,167,7.6,80
53000000,0,-53000000,19.412028,93,5.9,28
63000000,183953723,120953723,16.791058,95,5.5,16
65000000,422610419,357610419,65.197968,117,7,28
80000000,516642939,436642939,32.829538,115,6.1,35
60000000,244082376,184082376,30.951203,115,6.9,35
60000000,284600000,224600000,103.698022,189,8.2,14
0,253625427,253625427,31.719463,100,5.6,28
150000000,314432665,164432665,47.973995,81,5.6,16
61000000,369330363,308330363,143.041543,145,7.9,9648
60000000,214034224,154034224,86.476817,119,7.3,28
58000000,352194034,294194034,59.824565,130,6.6,12
60000000,149705852,89705852,18.345613,116,6.1,80
60000000,264118201,204118201,56.488027,103,7.8,35
70000000,218613188,148613188,29.464852,99,6.8,12
60000000,164433867,104433867,18.106021,92,5.6,35
61000000,131940411,70940411,42.881415,109,6.6,28
60000000,93375151,33375151,18.735024,87,5,35
60000000,176070171,116070171,62.766854,110,6.6,28
60000000,93354918,33354918,24.153567,101,5.9,10749
60000000,171757863,111757863,41.515702,83,6,12
70000000,171844840,101844840,26.676487,113,5.3,35
60000000,157920733,97920733,16.278022,107,5.9,12
60000000,129181830,69181830,18.831023,94,5.7,35
61000000,311256926,250256926,113.161483,132,6.4,28
60000000,204594016,144594016,28.800112,133,5.8,18
60000000,0,-60000000,19.705489,125,6.5,35
58000000,71664962,13664962,41.430245,111,6.6,28
55000000,100230832,45230832,23.127561,163,6.8,18
60000000,186883563,126883563,12.867352,170,6.7,18
65000000,217764291,152764291,44.815022,120,7,18
60000000,165333180,105333180,37.537093,92,5.3,28
60000000,74541707,14541707,10.99991,115,6.2,18
60000000,218340595,158340595,56.868399,130,6.3,80
60000000,73648228,13648228,22.991269,105,5.6,28
60000000,0,-60000000,15.798622,111,6.7,10402
60000000,137551594,77551594,38.820858,106,6.2,18
0,0,0,10.292864,89,4.3,35
60000000,124596398,64596398,51.146047,100,7.3,16
60000000,163403799,103403799,20.501582,91,4.9,53
70000000,130293714,60293714,45.299089,146,7.3,28
50000000,61112916,11112916,4.280619,98,4.5,35
60000000,170268750,110268750,28.848842,101,5.6,35
60000000,129832389,69832389,22.501041,89,5.5,10751
66000000,99318987,33318987,47.479755,122,6.5,14
70000000,56702901,-13297099,10.147321,115,6.1,18
60000000,107139399,47139399,39.539045,90,6.7,10751
60000000,159330280,99330280,19.747459,124,6.1,28
60000000,96269812,36269812,29.018826,119,5.9,28
60000000,0,-60000000,4.801849,119,5.9,18
60000000,50877145,-9122855,16.493576,93,5.8,12
0,0,0,21.549232,98,5.3,53
60000000,104324083,44324083,13.080725,100,5.6,28
60000000,50549107,-9450893,42.538258,105,5.9,28
60000000,101134059,41134059,29.876507,124,6.4,18
60000000,205754447,145754447,61.849521,99,5.8,28
70000000,162000000,92000000,37.44963,109,5.9,878
61000000,95696996,34696996,37.378081,124,6.9,28
60000000,108255770,48255770,30.656345,97,6.6,16
75000000,46683377,-28316623,15.142701,104,6.3,18
60000000,469160692,409160692,59.547928,100,7.5,12
0,0,0,19.998581,115,5.3,28
60000000,43061982,-16938018,27.615108,101,6,12
60000000,105200903,45200903,29.041198,113,6.2,80
60000000,62357900,2357900,25.293538,97,4.6,35
60000000,122233971,62233971,23.85119,134,7,18
60000000,87784194,27784194,21.685719,127,6.7,28
78146652,60000000,-18146652,13.630049,125,5.7,10749
65000000,36850101,-28149899,6.80692,94,5.1,35
60000000,77920346,17920346,15.352807,108,5.8,28
70000000,104945765,34945765,23.661071,91,5.6,878
60000000,67312826,7312826,21.605533,117,6.1,878
60000000,119940815,59940815,22.620125,100,5.8,80
0,0,0,18.587114,111,6.6,18
80000000,74901339,-5098661,24.657931,117,6.2,80
60000000,33956608,-26043392,12.621769,110,5.8,27
60000000,55003135,-4996865,21.08952,96,5.7,35
60000000,73174566,13174566,18.380176,101,5.9,28
60000000,0,-60000000,18.877795,111,6,28
60000000,31720158,-28279842,17.299333,109,6.6,18
80000000,39459427,-40540573,16.848899,126,6.3,14
60000000,47383689,-12616311,21.547446,122,7.4,18
0,141702264,141702264,16.930969,78,5.1,16
60000000,71073932,11073932,36.689223,101,4.7,28
60000000,78309131,18309131,28.350927,87,5.4,28
60000000,26288320,-33711680,18.815442,86,6.6,10751
60000000,26673242,-33326758,29.787135,96,6.5,27
60000000,52322400,-7677600,8.927137,104,6.1,18
50000000,49111202,-888798,15.213484,121,5.7,18
60000000,17800000,-42200000,13.155999,140,6.3,28
72000000,27642707,-44357293,15.433244,131,7,28
90000000,14828081,-75171919,5.762037,91,4.9,27
60000000,30800231,-29199769,22.736038,118,6,18
60000000,90565421,30565421,45.514031,130,6.2,28
60000000,50650079,-9349921,18.676291,90,5,35
30000000,25473093,-4526907,14.376463,105,5.3,18
80000000,0,-80000000,14.298297,122,5.7,35
60000000,57490374,-2509626,27.018886,106,6,12
60000000,39031337,-20968663,14.84856,103,4.7,28
60000000,30418560,-29581440,52.417529,106,5.4,35
60000000,0,-60000000,15.406173,127,4.1,12
35000000,0,-35000000,6.523472,127,6.7,18
68490000,193677158,125187158,4.72629,120,6,28
80000000,10166502,-69833498,8.923215,132,6.8,28
58000000,783112979,725112979,514.569956,108,7.4,28
60000000,0,-60000000,9.265672,114,4.9,18
58800000,542307423,483507423,87.53437,133,7.4,10752
58000000,158162788,100162788,45.351617,103,6.2,12
58000000,102854431,44854431,13.43573,95,6.5,35
83000000,59468275,-23531725,6.248309,90,4.4,878
63000000,189015611,126015611,31.294717,102,5.7,28
58000000,41299492,-16700508,7.739276,114,5.7,35
60000000,0,-60000000,19.694695,119,4.9,35
58000000,85280250,27280250,14.403696,103,5.1,35
58000000,44000000,-14000000,1.551497,119,6.1,35
60000000,300228084,240228084,2.143764,97,5.8,28
58000000,50365377,-7634623,12.29603,125,5.9,18
57000000,152944660,95944660,33.8473,144,7.2,18
70000000,58058367,-11941633,21.723897,116,5.5,35
57000000,115267375,58267375,31.791979,103,6.4,14
60000000,61347797,1347797,14.113066,97,6,28
57000000,149217355,92217355,48.622278,95,4.7,28
57000000,62112895,5112895,9.061866,131,5.5,18
56000000,113006880,57006880,35.4763,95,5.8,28
56000000,57223890,1223890,23.438398,86,6,12
55000000,677945399,622945399,138.133331,142,8.2,35
60000000,361366633,301366633,47.336034,92,5.5,35
55000000,330444045,275444045,29.97224,108,6.6,35
55000000,346079773,291079773,47.845589,81,6.7,12
55000000,300218018,245218018,48.507081,143,6.9,28
54000000,128769345,74769345,20.28119,95,5.4,14
70000000,368100420,298100420,34.576913,118,6.4,35
55000000,0,-55000000,22.573237,92,5.4,12
55000000,231449203,176449203,36.194802,103,6,35
55000000,95000000,40000000,52.786917,134,7.6,28
55000000,152263880,97263880,38.06168,97,5.9,35
50000000,287928194,237928194,19.830132,100,6,14
55000000,192330738,137330738,79.922059,132,7.1,53
55000000,154906693,99906693,19.738215,105,5.6,35
53000000,157387195,104387195,20.334629,116,7,28
55000000,307077295,252077295,80.581367,117,7.7,18
55000000,223387299,168387299,32.05145,98,6.1,53
55000000,214015089,159015089,15.064058,123,5.9,18
55000000,198685114,143685114,21.272734,114,6.4,18
30000000,180949000,150949000,79.754966,111,7.7,28
55000000,0,-55000000,13.191829,97,6,35
30000000,152159461,122159461,50.622607,136,7.6,28
55000000,63408614,8408614,22.787667,104,6.1,28
55000000,149022650,94022650,29.498304,104,6.3,14
55000000,56932305,1932305,25.400935,110,6.2,12
55000000,121969216,66969216,17.231675,133,5.8,28
55000000,187361754,132361754,32.835777,94,5.7,35
55000000,127906624,72906624,17.097041,104,6.3,28
55000000,110000000,55000000,14.414937,91,5.7,16
50000000,159773545,109773545,45.856409,114,6.2,878
55000000,141047179,86047179,7.027139,134,5.9,36
55000000,41610884,-13389116,32.657488,122,6.7,28
50000000,75000000,25000000,12.46525,109,6.4,12
55000000,259207227,204207227,39.882276,95,7,10751
68000000,68267862,267862,39.395881,98,5.3,35
55000000,34234008,-20765992,8.634954,94,6,18
80000000,0,-80000000,7.386394,126,6.2,18
55000000,33828318,-21171682,8.802525,118,5.1,35
0,33472850,33472850,10.449975,91,5.4,35
60000000,118338361,58338361,23.700759,88,6.4,16
55000000,113020255,58020255,27.50916,141,7.3,80
50000000,60209334,10209334,20.58862,107,5.3,28
55000000,18626419,-36373581,4.366488,116,5.7,18
70000000,154648887,84648887,18.927463,143,7,53
55000000,74237563,19237563,15.274137,114,6.6,18
62000000,52304001,-9695999,29.954302,93,5.4,28
56000000,12923936,-43076064,4.362535,214,6.1,18
55000000,11466088,-43533912,4.700024,100,5.2,28
55000000,0,-55000000,12.340384,107,5.7,35
50000000,80383290,30383290,14.808304,112,6.2,35
57000000,28283637,-28716363,9.27875,95,4.2,28
55000000,89519773,34519773,22.863516,119,6.9,18
47000000,0,-47000000,23.05451,133,7.1,18
2000000,9250000,7250000,23.962109,153,7.3,18
55000000,6416302,-48583698,12.669778,96,5.3,28
54000000,155010032,101010032,67.169587,117,6.2,14
55000000,168167691,113167691,41.472404,123,7.5,18
55000000,9489829,-45510171,22.503935,92,5.2,28
54000000,136766062,82766062,59.194915,162,7.1,80
57000000,52034889,-4965111,22.894898,123,6.1,35
54000000,130431368,76431368,18.600367,108,5.4,35
54000000,190458706,136458706,30.515175,127,6.5,28
54000000,7266209,-46733791,9.053456,121,3.5,18
55000000,9450897,-45549103,7.768223,125,5.7,18
46000000,107196498,61196498,19.643365,99,5.5,28
53000000,139804348,86804348,45.565918,94,7.4,16
52500000,179213434,126713434,57.374341,127,7.4,18
75000000,54249294,-20750706,8.41856,89,5.4,9648
53000000,98837872,45837872,46.049902,122,6.3,80
90000000,65900249,-24099751,23.9366,132,6.7,10752
53000000,126690726,73690726,49.593978,109,7.2,18
67000000,25037897,-41962103,16.637642,191,6.8,53
0,0,0,1.453765,172,5.9,18
0,5761917,5761917,6.162872,124,5.4,18
52000000,352114312,300114312,73.944049,141,7.7,18
40000000,132820716,92820716,38.306954,157,6.7,53
52000000,204999686,152999686,26.251217,106,5.6,10749
52000000,609841637,557841637,30.780599,108,6.4,35
52000000,216485654,164485654,25.41929,125,5.7,35
50000000,110803676,60803676,15.98212,104,5.1,28
52000000,98126565,46126565,40.072583,170,7.2,18
52000000,75450437,23450437,32.015477,112,5.9,35
82000000,47434430,-34565570,24.444186,118,6.9,35
52000000,116112375,64112375,40.06688,178,7.8,18
52000000,52826594,826594,27.916284,92,6.1,28
52000000,0,-52000000,15.20707,104,5.1,28
51000000,149270999,98270999,39.001682,116,6.1,35
51000000,72779000,21779000,10.430832,90,5.3,16
0,47231070,47231070,5.952527,93,5.1,35
50000000,709827462,659827462,94.815867,130,5.6,12
60000000,484409218,424409218,67.298732,90,7.3,12
50200000,127869379,77669379,26.60772,106,6.5,878
48000000,390493908,342493908,28.803729,143,6.6,12
50000000,273552592,223552592,27.039636,139,6.7,35
50000000,549368315,499368315,68.87691,106,6.3,35
50000000,314178011,264178011,37.885022,139,7.2,35
50000000,202292902,152292902,35.537397,115,7,35
50000000,173649015,123649015,38.125008,119,6,35
50000000,171269535,121269535,18.121404,96,5.6,35
50000000,260095987,210095987,37.069253,112,6.6,53
52000000,256271286,204271286,30.347332,131,7.1,18
50000000,177371441,127371441,23.854701,116,6.3,35
50000000,188441614,138441614,52.380982,112,7,80
60000000,223664608,163664608,50.163785,123,7.2,27
70000000,225990978,155990978,43.849351,104,6.4,35
50000000,216972543,166972543,45.318703,107,6.2,28
0,0,0,16.368283,124,6.9,18
50000000,242786137,192786137,38.616744,96,5.8,35
50000000,212902372,162902372,65.90161,125,5.6,14
45000000,184376254,139376254,45.220386,129,7.3,80
90000000,161626121,71626121,17.457947,100,6.7,18
50000000,152022101,102022101,10.755847,109,5,28
50000000,120081841,70081841,38.629763,124,6.5,18
50000000,155446362,105446362,32.693093,121,5.9,28
50000000,88715192,38715192,18.806031,97,5.5,35
50000000,161451538,111451538,32.233713,110,5.4,18
50000000,142851197,92851197,37.990705,118,7,35
50000000,200804534,150804534,17.667826,80,5.2,16
60000000,0,-60000000,9.225166,99,5.2,35
50000000,110206216,60206216,46.180421,133,7,18
50000000,189859560,139859560,30.397496,127,6.3,28
50000000,222809600,172809600,83.295796,106,6.8,28
50000000,106303988,56303988,23.935053,98,5.5,12
54000000,132511035,78511035,84.630969,132,7.7,28
50000000,88323487,38323487,16.251204,115,6,28
50000000,69834815,19834815,9.894346,86,6.2,12
50000000,66002004,16002004,12.050755,101,5.1,35
50000000,100020092,50020092,11.596207,113,6,53
50000000,224803475,174803475,53.02787,88,5.7,14
50000000,119137784,69137784,14.382253,124,6.3,53
50000000,144492830,94492830,43.450266,109,5.9,28
50000000,94000000,44000000,16.871194,128,6.3,18
50000000,69411370,19411370,42.526529,144,7,28
50000000,97437106,47437106,34.890999,95,7.3,10749
45000000,82800000,37800000,18.186026,105,5.6,53
50000000,50068310,68310,13.576765,121,6.4,80
50000000,48169156,-1830844,19.434672,125,6,28
50000000,109423648,59423648,62.925175,129,7.5,18
50000000,97607453,47607453,32.927994,125,6.3,27
0,0,0,14.837288,118,6.1,35
50000000,234989584,184989584,39.920035,113,6.1,35
50000000,44547681,-5452319,28.725621,140,6.8,28
50000000,160602194,110602194,20.566554,89,5.8,28
50000000,119208989,69208989,20.333953,104,5.5,28
50000000,41482207,-8517793,33.98637,106,6.2,35
50000000,83719388,33719388,42.472324,141,7.2,18
50000000,0,-50000000,15.931084,124,5.8,28
45000000,129394835,84394835,29.880122,94,6.1,27
50000000,40203020,-9796980,28.803802,108,6.1,35
50000000,55495563,5495563,14.993459,105,6.1,53
50000000,49000000,-1000000,9.114168,102,4.5,28
50000000,69425966,19425966,12.31101,92,4.4,12
40000000,144056873,104056873,41.362082,119,6.3,18
50000000,49718611,-281389,13.298205,119,5.9,18
40000000,60462347,20462347,19.085403,99,6.2,28
50000000,0,-50000000,9.622345,137,6.3,18
50000000,113309743,63309743,11.106006,115,4.4,18
50000000,83761844,33761844,12.25622,87,5,10751
50000000,105197635,55197635,13.365715,129,5.8,18
50000000,56714147,6714147,16.167093,120,6,80
50000000,30303072,-19696928,23.073933,132,6,28
50000000,82169884,32169884,6.567065,121,6,80
50000000,58900031,8900031,6.22577,95,5.9,35
44000000,63327201,19327201,42.933027,125,6,28
50000000,42792561,-7207439,19.226763,98,6.2,28
50000000,26199517,-23800483,10.089065,110,6.1,80
50000000,60161391,10161391,13.391833,118,6,18
50000000,42277365,-7722635,21.637234,97,5.6,28
70000000,23159305,-46840695,61.245957,86,7.6,12
50000000,34808403,-15191597,25.237969,119,7.1,12
50000000,25035950,-24964050,21.589393,139,6.6,10752
50000000,38955598,-11044402,22.442241,130,7.3,18
40000000,0,-40000000,6.004422,100,5.4,35
50000000,71561644,21561644,74.64653,114,6.3,28
51500000,55112356,3612356,35.481169,100,7.2,53
50000000,44434439,-5565561,14.723467,110,5.8,28
60000000,66976317,6976317,21.084542,148,6.2,12
49900000,26121638,-23778362,21.408222,102,5.2,35
50000000,38502340,-11497660,19.267479,84,5.8,18
50000000,10541523,-39458477,3.314004,114,5.9,28
50000000,16671505,-33328495,21.312186,99,5.8,28
50000000,10382407,-39617593,7.44268,135,5.5,18
22000000,24188922,2188922,12.54949,108,6.5,18
50000000,22944502,-27055498,18.394571,127,6,28
50000000,9851610,-40148390,8.189406,95,5.2,28
50000000,40828540,-9171460,27.631262,95,5.6,28
60000000,60052138,52138,40.721373,124,5.6,14
55000000,0,-55000000,11.329727,109,5.9,35
50000000,55969000,5969000,37.253774,100,4.7,35
50000000,6808550,-43191450,6.397388,88,5,35
60000000,0,-60000000,2.275331,105,5.4,35
50000000,28931401,-21068599,30.387148,105,5.3,14
50000000,12764201,-37235799,8.139676,97,3.9,28
49000000,72700000,23700000,21.746245,87,5.7,28
49000000,20423389,-28576611,2.808428,104,6.2,28
50000000,36348784,-13651216,31.02233,116,7.2,18
48000000,207515725,159515725,25.170217,147,6.9,53
48000000,474171806,426171806,80.972475,127,7.6,12
0,68929150,68929150,26.38704,130,6.5,18
49000000,104399548,55399548,116.700319,120,6.6,80
73000000,151493655,78493655,33.884459,118,6.5,18
48000000,196397415,148397415,53.043124,111,6.5,80
0,0,0,0.716764,0,4.3,27
75000000,108000000,33000000,34.973086,114,6.6,28
50000000,3324330,-46675670,40.371098,137,6.1,80
48000000,85498534,37498534,18.60049,112,6,12
48000000,50315140,2315140,30.920075,120,7.1,18
0,0,0,11.940711,118,6,35
48000000,90383208,42383208,19.348007,93,5.6,14
58000000,25928721,-32071279,8.59075,127,6.6,10402
55000000,70016220,15016220,48.801089,122,6.9,37
48000000,325771424,277771424,88.844777,109,6.1,53
48000000,77745568,29745568,16.000178,123,6.5,10749
47000000,102825796,55825796,19.525659,96,5.7,35
0,528972,528972,1.246883,101,6.6,18
47000000,103738726,56738726,7.859226,103,5.9,12
48000000,124305181,76305181,18.102572,113,6.6,18
48000000,35743308,-12256692,7.226115,132,6.5,35
15000000,125212904,110212904,63.071046,93,7.2,28
0,0,0,24.132271,167,7.7,18
47000000,38085778,-8914222,10.410933,75,4.6,16
47000000,12379402,-34620598,6.067212,104,5.7,18
38000000,299288605,261288605,15.401855,105,6.3,35
0,0,0,10.698929,102,5.5,35
46000000,113714830,67714830,41.322708,118,6.8,80
46000000,150000000,104000000,25.6713,111,7,878
47000000,10539000,-36461000,22.581313,80,4.4,28
46000000,100860818,54860818,12.971122,117,6.2,18
45000000,181000000,136000000,26.721386,86,6.4,35
25000000,15436808,-9563192,24.672234,127,6.6,80
46000000,5200000,-40800000,0.146783,140,6.5,18
46000000,341631208,295631208,28.964162,91,5,14
45000000,376141306,331141306,49.353524,91,6.1,28
48000000,220673217,172673217,36.585509,84,5.8,35
45000000,212000000,167000000,32.624355,111,6.1,35
45000000,101702060,56702060,53.090422,93,5.8,28
40000000,95149435,55149435,30.002907,113,6,35
45000000,195268056,150268056,17.923254,141,6.3,18
45000000,117615211,72615211,17.746719,119,6.4,18
45000000,175372502,130372502,31.305336,97,7,18
45000000,178051587,133051587,19.637704,117,6.3,18
43000000,154749918,111749918,10.411996,101,5.6,10749
46000000,122126687,76126687,88.496873,153,7.9,18
45000000,104876233,59876233,52.081131,122,7.3,28
45000000,90683916,45683916,30.816341,102,6.9,35
45000000,141220678,96220678,35.376971,83,5.4,35
45000000,165184237,120184237,17.047276,103,6.5,35
45000000,131183530,86183530,43.815492,120,6.5,27
30000000,76669806,46669806,23.234651,136,7.3,18
45000000,94935764,49935764,17.270539,89,5.9,28
45000000,136885767,91885767,27.684779,89,4.7,12
45000000,113916474,68916474,26.79781,100,5.8,35
40000000,244931766,204931766,37.073127,135,7,35
120000000,363258859,243258859,87.350802,95,6.8,12
35000000,74558115,39558115,26.134678,122,6.6,27
45000000,170362582,125362582,16.582709,110,5.5,28
45000000,53854588,8854588,10.731574,135,5.9,35
0,0,0,2.094151,111,6.2,35
45000000,56070433,11070433,8.99269,95,5.6,10749
50000000,104478416,54478416,51.742065,109,6.6,12
0,0,0,7.157635,93,4.3,35
45000000,148412065,103412065,12.06538,94,6.1,27
40000000,123494610,83494610,44.120328,117,6.6,35
45000000,38399961,-6600039,6.156015,112,6.4,12
45000000,0,-45000000,12.362876,111,6.1,28
45000000,0,-45000000,11.095914,96,5.9,12
45000000,82966152,37966152,31.856589,131,6.2,80
25000000,56422687,31422687,24.459948,94,6.1,28
40000000,160583018,120583018,28.029015,88,6,12
50000000,55181129,5181129,20.239061,88,5.5,14
40000000,30925690,-9074310,25.876582,137,6.5,28
0,0,0,11.872841,133,7.1,12
35000000,75225693,40225693,20.360549,119,6.7,18
55000000,65664721,10664721,32.31022,105,6.2,28
70000000,72108608,2108608,27.568194,101,5.4,28
45000000,0,-45000000,6.250282,92,4.7,28
45000000,0,-45000000,11.120344,117,5.5,35
45000000,57881056,12881056,13.707183,86,5.3,12
35000000,29400000,-5600000,12.495436,123,6.5,80
45000000,38058335,-6941665,6.803965,134,6.1,35
45000000,17300889,-27699111,9.025236,100,4.7,12
57000000,0,-57000000,7.524671,117,5.8,18
44000000,13681765,-30318235,3.770161,192,7.1,36
45000000,60222298,15222298,21.118196,128,6.7,53
45000000,11203026,-33796974,6.513856,106,6,12
45000000,9323833,-35676167,11.387408,160,6.3,18
110,0,-110,9.950505,114,6.6,28
45000000,42487390,-2512610,14.813057,99,5,28
40000000,8493890,-31506110,5.201688,85,6.3,28
45000000,4607608,-40392392,5.361699,139,6.4,18
45000000,2154540,-42845460,3.848893,103,4,28
45000000,160078586,115078586,35.6585,101,6,80
65000000,73706,-64926294,5.258726,87,2.3,16
44500000,232324128,187824128,62.01056,120,7.1,18
44000000,368875760,324875760,54.884297,130,7.2,12
40000000,136000000,96000000,33.747825,110,5.5,28
44000000,165615285,121615285,16.245068,147,7.3,80
44000000,300400432,256400432,38.653969,96,6.3,28
44000000,0,-44000000,3.937352,118,5.5,18
2600000,84300000,81700000,46.007991,88,6.9,16
44000000,3484331,-40515669,5.380124,219,6.4,28
50000000,111340801,61340801,49.020045,106,6.4,14
40000000,34227298,-5772702,24.821138,109,5.6,18
43000000,80049764,37049764,19.043286,136,7,18
43000000,0,-43000000,5.418921,103,6,35
45000000,50871113,5871113,25.999888,103,6.6,28
43000000,68696770,25696770,18.65632,84,5.3,10749
42000000,270248367,228248367,23.736535,154,6.6,18
44000000,48190704,4190704,21.75433,99,6.8,18
40000000,51070807,11070807,44.094856,93,6.3,28
42000000,201585328,159585328,62.714026,109,6.7,28
42000000,363889678,321889678,28.969151,124,7,10749
45000000,224834564,179834564,31.789029,84,6.5,16
42000000,171963386,129963386,33.238296,90,5.8,35
40000000,70100000,30100000,6.420434,117,5.4,35
43000000,158674180,115674180,37.654688,117,6.5,28
31115000,71000000,39885000,13.244365,248,6.7,18
0,73100172,73100172,26.799913,105,6,35
42000000,63781810,21781810,14.046705,115,6.1,18
42000000,0,-42000000,3.844926,126,6.5,35
32000000,55157539,23157539,14.733513,119,6.1,18
42000000,0,-42000000,16.122168,83,5.4,35
32000000,156167015,124167015,28.22119,133,5.9,12
42000000,89162162,47162162,45.151657,100,5.6,14
60000000,56359980,-3640020,15.205371,120,5.7,28
48000000,20915465,-27084535,14.587367,104,4,12
42000000,24127895,-17872105,34.828241,122,7,80
31000000,177394432,146394432,23.607392,99,7.2,18
40000000,36893721,-3106279,19.438503,91,5.3,28
44000000,12342632,-31657368,74.168016,112,6.1,28
42000000,11087569,-30912431,7.349497,100,6.3,12
33000000,14000000,-19000000,7.663515,100,6.8,28
41000000,215000000,174000000,32.798571,110,6.8,18
0,0,0,5.794466,100,5.3,12
65000000,117487473,52487473,36.670399,132,6.6,12
41000000,0,-41000000,14.653718,88,5.3,53
40000000,672806292,632806292,73.085576,107,7.7,9648
42000000,46221189,4221189,34.041407,102,6.2,28
41000000,7448385,-33551615,9.419726,100,5.6,35
8000000,90815558,82815558,28.456572,126,6.9,18
40000000,251171807,211171807,49.664128,138,6.8,18
40000000,317375031,277375031,36.238968,108,6.7,35
70000000,177841558,107841558,19.439386,105,6.2,80
40000000,332000000,292000000,43.345252,108,7.4,12
40000000,126546825,86546825,115.241998,89,6.3,28
40000000,571006128,531006128,98.755657,125,5.2,18
38000000,197011982,159011982,21.998734,84,4.7,28
40000000,152266007,112266007,25.219805,149,7,80
40000000,190212113,150212113,26.516624,98,6,35
40000000,149295601,109295601,37.084384,121,7.4,28
40000000,107458785,67458785,21.661028,128,6.7,35
40000000,320170008,280170008,68.794673,134,7,27
40000000,224920315,184920315,69.27822,120,7.1,18
40000000,177259441,137259441,26.253357,129,6.2,35
45000000,178262620,133262620,32.549282,83,5.3,35
40000000,161834276,121834276,24.992057,116,5.7,27
40000000,244527583,204527583,45.769562,118,7.1,12
40000000,111811453,71811453,36.301202,100,5.9,35
40000000,215862692,175862692,45.022964,128,7.1,10749
40000000,129540499,89540499,22.853006,123,6.6,10749
40000000,95020213,55020213,31.884559,128,6.8,18
40000000,128798265,88798265,31.385257,139,7,53
40000000,169837010,129837010,67.767785,110,5.4,35
40000000,120455994,80455994,24.287306,120,6.7,12
35000000,194564672,159564672,53.114573,121,7.1,35
40000000,124827316,84827316,25.136082,102,6.1,28
40000000,75505856,35505856,37.776566,112,7.1,28
40000000,124731534,84731534,21.743321,152,7.2,18
40000000,158733820,118733820,66.003433,124,7.2,28
40000000,151161491,111161491,24.862767,90,6.2,18
41000000,91636986,50636986,25.391899,105,6.5,35
40000000,141069860,101069860,29.854773,114,5.7,35
40000000,205405498,165405498,26.82041,189,7.5,18
40000000,138259062,98259062,17.61292,99,5.4,35
57000000,147845033,90845033,21.021809,123,5.8,28
20000000,136267476,116267476,52.571674,102,6.1,35
40000000,196781193,156781193,34.519636,109,6.2,35
40000000,186167139,146167139,32.478077,82,5.4,27
40000000,165478348,125478348,48.445978,141,7.2,53
40000000,91753202,51753202,24.012986,106,6,28
40000000,90029656,50029656,17.869443,109,5.9,35
50000000,170128460,120128460,14.231899,107,5.9,18
40000000,54682547,14682547,23.088571,110,6.2,35
40000000,87840042,47840042,19.833664,96,5,28
35000000,75395048,40395048,26.595983,131,7.3,28
40000000,85412898,45412898,26.072228,119,7,80
30000000,130786397,100786397,38.643914,113,6.5,28
40000000,109676311,69676311,74.440708,130,8,18
42000000,107670357,65670357,82.185281,108,6.1,35
40000000,74597643,34597643,18.14218,89,5.7,16
40000000,120175290,80175290,41.570047,139,7.3,28
40000000,191185897,151185897,23.331459,130,6.2,28
40000000,126248813,86248813,47.649554,107,6,28
0,0,0,7.519433,116,5.8,35
40000000,92913171,52913171,32.908414,96,6.4,53
40000000,114830111,74830111,29.88736,99,6.5,10749
43000000,91974818,48974818,29.105407,104,6.4,18
0,51854875,51854875,16.394452,105,6.5,14
40000000,84601681,44601681,19.574774,101,6,35
40000000,67347013,27347013,14.199933,134,6.8,10402
40000000,45916769,5916769,12.229516,135,6.7,18
40000000,141591324,101591324,27.303608,98,5.8,27
36000000,74000000,38000000,3.698276,155,6.8,18
40000000,0,-40000000,7.021871,106,5.8,12
40000000,41797066,1797066,39.381913,94,4.9,14
40000000,0,-40000000,14.398356,95,5.4,35
65000000,0,-65000000,8.680334,103,5.7,18
40000000,145896422,105896422,17.659032,96,6.2,35
40000000,97552050,57552050,43.151268,104,6.5,12
40000000,41863726,1863726,15.283444,95,5.4,35
40000000,97138686,57138686,35.21926,111,6.1,27
40000000,96618699,56618699,25.580272,123,6.1,53
38000000,34416893,-3583107,10.794175,140,6.7,18
40000000,126069509,86069509,72.641296,97,5.3,35
40000000,36037909,-3962091,3.415534,94,5,35
47000000,157887643,110887643,38.555482,92,5.9,27
0,0,0,6.786117,102,5.3,35
40000000,55707411,15707411,24.313684,122,7,18
30000000,50451307,20451307,9.965073,103,5.9,35
40000000,0,-40000000,15.055732,102,5.5,35
0,0,0,32.808675,116,5.8,35
25000000,48063435,23063435,8.178203,108,5.4,12
40000000,55247881,15247881,31.066874,129,6.9,18
40000000,58785180,18785180,22.491388,102,6.1,35
40000000,46442528,6442528,12.885985,117,6.3,18
40000000,30199105,-9800895,7.832337,117,5.6,80
40000000,31670620,-8329380,10.433667,135,6.7,18
40000000,0,-40000000,3.321949,107,4.9,18
75000000,29000000,-46000000,4.842626,90,5,35
40000000,49627779,9627779,13.210898,96,4.6,14
40000000,27053815,-12946185,3.296933,104,5.2,28
35000000,0,-35000000,22.939557,115,6.4,18
40000000,65754228,25754228,19.372805,119,6.4,18
40000000,62771059,22771059,13.445697,99,5.4,27
500000,3000000,2500000,17.002096,110,7.2,18
40000000,24332324,-15667676,4.516953,128,5.9,35
40000000,60965854,20965854,33.785969,108,6.5,28
40000000,38172500,-1827500,16.059443,86,6.9,14
40000000,22433915,-17566085,3.476966,108,5.7,80
0,0,0,5.778724,128,5.9,18
40000000,46546197,6546197,7.360793,84,4.7,28
0,0,0,3.621837,111,6,18
45000000,20350754,-24649246,14.513305,128,4.9,18
40000000,60474340,20474340,22.364549,123,6.5,18
40000000,0,-40000000,6.90894,101,5.7,28
63600000,19412993,-44187007,4.494788,102,4.8,28
42000000,180274123,138274123,47.559928,113,7,53
55000000,14375181,-40624819,2.410546,107,4.2,28
40000000,46471023,6471023,41.258956,87,7.5,12
40000000,16872671,-23127329,8.980846,103,5.7,35
40000000,14358033,-25641967,7.222985,99,5.7,35
10000000,173921954,163921954,73.720244,122,7.8,35
0,0,0,10.0403,91,5.5,35
60000000,13395939,-46604061,15.219263,103,5.6,35
40000000,24719215,-15280785,8.303696,107,6.6,12
38000000,28121100,-9878900,4.746085,106,5.9,18
40000000,18902015,-21097985,6.756886,101,3.2,27
40000000,28169671,-11830329,16.424807,109,5.5,12
40000000,19322135,-20677865,15.590001,89,5.9,28
0,0,0,5.483671,103,6.3,35
0,0,0,1.630541,115,5.2,28
45000000,10667893,-34332107,14.566664,82,4.2,28
33000000,20645327,-12354673,28.353517,108,6.5,28
40000000,0,-40000000,9.579975,102,6.1,28
40000000,10959475,-29040525,2.911819,93,5,28
0,0,0,10.844882,88,4.8,35
50000000,32017803,-17982197,51.502884,107,7,878
40000000,22044277,-17955723,13.119133,91,6,18
40000000,0,-40000000,4.238482,94,5.4,12
40000000,13644292,-26355708,26.935458,115,5.5,28
40000000,23937870,-16062130,16.282962,93,5.1,12
20000000,117760134,97760134,31.690456,105,6.6,53
20000000,7563728,-12436272,17.842246,107,6.2,28
0,0,0,8.048305,101,6.6,28
30000000,0,-30000000,14.188982,111,7.1,35
40000000,0,-40000000,6.884467,126,6.3,28
25000000,0,-25000000,8.212018,112,4.3,28
39200000,86758912,47558912,64.238688,126,6.7,28
25000000,0,-25000000,17.375562,90,6.5,12
0,0,0,6.7698,90,5.9,28
15000000,94000000,79000000,44.690107,102,7.3,14
40000000,100000000,60000000,16.254032,159,7.5,28
39000000,101229792,62229792,37.492928,107,6.7,18
0,69485490,69485490,18.678415,102,5.8,35
39000000,35287788,-3712212,27.908783,87,6.6,16
39000000,38869464,-130536,45.388937,119,7.4,878
39000000,6614280,-32385720,2.817364,106,4.5,10749
39000000,75850624,36850624,22.164202,125,5.3,35
40000000,44907260,4907260,21.362949,113,6,35
80341000,127814609,47473609,14.8375,150,7.1,12
30000000,180622424,150622424,18.256028,108,6,35
38000000,205298907,167298907,22.332927,96,6.4,35
0,0,0,5.417787,90,5.5,35
38000000,119723358,81723358,24.085144,100,5.3,28
38000000,120000000,82000000,14.779041,118,6.4,878
3860000,64076736,60216736,19.947265,130,6.3,28
38000000,114156230,76156230,16.801218,120,6.7,18
40000000,0,-40000000,5.057695,88,6.8,12
50000000,73956241,23956241,20.825781,146,7.2,18
38000000,51801187,13801187,11.500783,114,6.2,18
35000000,0,-35000000,13.932203,123,5.7,80
38000000,107597242,69597242,41.258487,94,5,28
53000000,29700000,-23300000,6.454634,102,5.6,18
38000000,0,-38000000,5.257009,99,5.5,35
38000000,58401898,20401898,30.359164,133,6.3,27
38000000,17380126,-20619874,3.426555,118,5.7,18
57000000,16991902,-40008098,11.60815,105,6,10402
10000000,47536959,37536959,18.664624,110,6.9,18
38000000,10300000,-27700000,10.047579,129,6.3,28
15000000,19629760,4629760,52.731379,109,7.8,27
38000000,98337295,60337295,46.630062,119,6.2,878
37000000,6482195,-30517805,4.131546,118,5.8,28
0,0,0,5.641978,110,5.4,28
55000000,17869048,-37130952,23.465539,90,6.2,12
32000000,28258060,-3741940,25.682509,137,7,18
38000000,5410749,-32589251,6.760922,93,4.3,12
40000000,9793496,-30206504,3.87823,130,7.1,18
38000000,109906372,71906372,57.889964,112,5.6,12
37000000,173567581,136567581,57.773583,133,7.3,18
37000000,154026136,117026136,24.218358,125,7,80
40000000,79700000,39700000,27.009723,110,5.8,10749
37000000,163720069,126720069,31.941347,96,6.5,35
37000000,100076342,63076342,14.353279,96,5.6,12
38000000,90247624,52247624,33.003828,123,7.7,18
37000000,48451803,11451803,30.993736,188,7.5,18
30000000,55583804,25583804,25.825771,107,5.3,28
38000000,112343513,74343513,46.078371,110,5.9,35
37000000,95404397,58404397,6.63839,113,6.7,18
37000000,392616625,355616625,127.084938,122,5.8,12
36000000,102244770,66244770,27.465433,116,7,18
65000000,117758500,52758500,16.865782,93,6.1,28
37000000,269994119,232994119,100.348805,110,6.8,35
36500000,21834845,-14665155,2.785832,115,5.3,28
36000000,50159144,14159144,9.176339,95,6.6,18
36000000,160000000,124000000,23.380757,134,5.8,12
36000000,64572262,28572262,33.926473,101,6,878
36000000,52424533,16424533,6.967857,107,6.7,10751
42000000,32168970,-9831030,11.470135,124,5.4,53
36000000,44350926,8350926,19.854932,109,5.8,28
37000000,26250020,-10749980,29.652536,105,5.2,18
0,0,0,8.102925,130,6.2,36
0,0,0,2.79483,127,6.3,18
37000000,96047633,59047633,11.492474,114,5.8,18
36000000,12532777,-23467223,70.398356,106,7.5,53
36000000,3003296,-32996704,1.068453,95,4.6,18
37000000,63800345,26800345,6.293217,81,5.2,16
0,0,0,3.457194,95,5.3,35
35000000,459270619,424270619,82.21166,100,7.2,35
36000000,156844753,120844753,19.167377,105,6.5,28
33000000,310940086,277940086,18.316151,95,6.2,12
35000000,411348924,376348924,44.104469,126,7,14
0,0,0,6.668679,112,5.9,18
35000000,321731527,286731527,36.172182,118,6.4,12
29000000,309208309,280208309,25.767395,129,7.2,18
35000000,147934180,112934180,21.543389,88,5.5,28
35000000,117000000,82000000,50.309843,98,6.5,35
38000000,252276927,214276927,49.292384,110,7.2,18
35000000,326551094,291551094,83.893257,109,7,35
35000000,139000000,104000000,24.616634,132,6.2,878
35000000,173965010,138965010,34.005726,111,5.6,35
35000000,182300000,147300000,27.714043,128,7,80
35000000,69823199,34823199,45.149948,123,6.5,18
35000000,140795793,105795793,72.774941,125,5.9,35
35000000,68915888,33915888,3.74263,105,5.5,35
27000000,231976425,204976425,29.381878,162,7,18
35000000,126216940,91216940,24.860326,138,7.7,80
35000000,86369815,51369815,11.041659,100,5.8,12
35000000,0,-35000000,11.897925,90,6.3,35
35000000,113374103,78374103,23.607071,108,5.5,878
1800000,25504513,23704513,38.204158,91,7.2,27
33000000,104155843,71155843,25.413955,107,6,27
0,0,0,28.98027,132,6.3,28
35000000,60251371,25251371,9.525037,123,6.8,18
34000000,95608995,61608995,18.39217,90,6,12
32000000,52277485,20277485,9.254647,109,6.8,18
35000000,150483765,115483765,40.526587,109,6.5,10749
35000000,108758521,73758521,50.179171,91,5.6,35
35000000,112544580,77544580,31.957947,125,7.3,35
34000000,48169908,14169908,19.822791,202,7.2,18
35000000,88058786,53058786,38.429648,134,5.6,35
35000000,92219310,57219310,13.707843,88,5.2,35
35000000,91353501,56353501,51.927471,92,6.2,14
35000000,69307224,34307224,14.503568,91,5.2,35
0,0,0,6.74556,80,5.2,35
30000000,58405313,28405313,11.120167,98,5.8,35
35000000,41954997,6954997,40.370442,127,7.4,80
33000000,102984862,69984862,40.715623,100,6.4,27
10700000,122200000,111500000,36.230204,114,7,27
0,0,0,23.666229,104,6,35
35000000,85416905,50416905,25.903237,100,5.2,28
40000000,173930596,133930596,60.231382,109,6.7,28
35000000,77477008,42477008,18.38292,106,5.7,35
35000000,59901913,24901913,14.029012,112,5.9,35
0,0,0,15.913783,95,5.1,12
35000000,35323292,323292,6.889633,102,6.9,35
35000000,99423521,64423521,19.286099,102,4.1,28
35000000,120072577,85072577,50.587541,150,8,18
35000000,0,-35000000,3.721272,101,6.4,18
40000000,68766121,28766121,17.157738,113,5.5,27
27000000,115505027,88505027,22.636908,104,6.7,18
35000000,84606030,49606030,28.069419,137,6,18
35000000,72436439,37436439,19.774543,110,6,27
35000000,45479110,10479110,11.644243,101,5.4,18
35000000,57120318,22120318,27.934978,108,5.9,878
35000000,32483410,-2516590,12.677505,101,5.9,18
35000000,40263020,5263020,8.737058,112,6.3,35
35000000,27107960,-7892040,12.343507,111,6.1,878
35000000,36098382,1098382,14.699342,102,5.8,35
45000000,30353232,-14646768,14.513243,101,5.1,28
35000000,25105255,-9894745,5.525544,155,6.3,80
8900000,4100000,-4800000,15.079993,93,5.6,80
35000000,93246388,58246388,23.835055,109,6,35
35000000,0,-35000000,5.926966,140,6.1,80
30000000,68369434,38369434,25.454549,104,5.5,18
31000000,27388767,-3611233,22.71592,96,5.9,10751
35000000,50363790,15363790,35.120736,123,7,18
35000000,82087155,47087155,19.893646,106,5.6,53
35000000,19478106,-15521894,14.051852,76,5.2,16
35000000,0,-35000000,9.011729,111,6.9,35
35000000,25871834,-9128166,19.088655,85,4.9,28
56000000,19701164,-36298836,29.490057,109,5.7,53
35000000,19294901,-15705099,11.195593,97,5.1,27
35000000,31083599,-3916401,17.709888,91,6.2,80
35000000,51680201,16680201,18.262017,87,5.4,28
35000000,29882645,-5117355,10.10364,132,6.5,10752
35000000,46216641,11216641,28.670477,118,5.7,28
31000000,41512007,10512007,16.736734,98,6,35
35000000,39340177,4340177,13.668633,92,4.6,35
30000000,0,-30000000,9.780588,93,5.3,28
27000000,16519460,-10480540,9.904881,117,5.8,14
35000000,63215872,28215872,9.789027,92,6,28
35000000,0,-35000000,6.81729,115,5.7,28
35000000,18317151,-16682849,10.73522,96,6.6,35
0,0,0,11.1399,111,6.4,18
35000000,13678913,-21321087,6.727949,94,5.7,28
35000000,27409889,-7590111,16.343317,105,7,18
40000000,12206028,-27793972,14.818718,101,5.3,28
32000000,54674226,22674226,43.862456,139,6.5,18
33000000,0,-33000000,2.706207,91,4.7,28
35000000,17508518,-17491482,27.903999,110,5.5,28
35000000,11560806,-23439194,3.746806,102,4.8,18
20500000,10089373,-10410627,17.112498,102,5.6,28
35000000,12506188,-22493812,10.304172,83,4.9,10751
35000000,61181942,26181942,37.335721,123,6.9,12
0,0,0,0.912395,103,4.7,14
35000000,42064105,7064105,16.782471,118,6.5,35
35000000,4651977,-30348023,3.503408,114,6.6,18
35000000,0,-35000000,9.122828,180,7.7,28
35000000,0,-35000000,5.419181,121,6.6,28
35000000,16838910,-18161090,9.07278,114,6.2,53
35000000,0,-35000000,2.864979,173,7.4,28
35000000,15000000,-20000000,2.877488,135,6.7,10752
38000000,635096,-37364904,5.516207,138,6.6,18
0,25147786,25147786,13.930763,148,7,18
35000000,10496317,-24503683,20.27704,93,5.8,28
0,0,0,0.126738,100,0,18
34000000,348319861,314319861,131.815575,113,7,28
35000000,14431253,-20568747,16.832312,91,5,35
34000000,32255440,-1744560,9.133747,139,7,18
35000000,15304890,-19695110,24.606012,96,6.8,18
70000000,11263966,-58736034,3.276912,101,5.3,28
35000000,2106557,-32893443,16.830184,96,5.1,28
41677699,187479518,145801819,39.58676,100,7.5,16
34000000,63013281,29013281,41.946523,128,7.3,18
75000000,19598588,-55401412,20.697556,109,5.4,18
34000000,0,-34000000,1.656695,114,5.3,10749
35000000,0,-35000000,17.932561,106,5.4,35
35000000,27330000,-7670000,15.50957,141,6.5,18
32000000,40382659,8382659,4.602185,195,7.1,18
40000000,243240178,203240178,40.379966,138,7.1,18
50000000,79958599,29958599,12.601306,101,5.3,28
30000000,173959438,143959438,24.389194,98,5.6,80
34000000,0,-34000000,12.867326,85,6.3,10751
30000000,64626786,34626786,23.328823,89,4.8,27
33000000,140470746,107470746,29.775441,99,6.7,10402
33000000,62022014,29022014,19.642328,105,5.1,28
33000000,0,-33000000,7.339908,96,4.9,9648
33000000,54700105,21700105,35.099611,124,6.1,28
30000000,27610873,-2389127,16.541791,118,6.6,18
30000000,40346186,10346186,31.92695,94,6.3,28
33000000,0,-33000000,9.060642,124,5.7,35
32350000,572700000,540350000,46.509071,135,7.9,12
30000000,22211426,-7788574,21.538222,108,5.8,28
32000000,113019290,81019290,33.923786,124,7.2,18
35000000,24159934,-10840066,20.908494,98,5.3,35
32000000,173398518,141398518,16.901954,97,6.4,35
32000000,152036382,120036382,15.039407,123,6.2,18
33000000,0,-33000000,13.655735,99,5.3,12
0,60328000,60328000,21.620317,101,6.7,14
32000000,80197993,48197993,14.642055,92,5.6,35
32500000,288383523,255883523,17.107065,125,6.5,35
32000000,126041322,94041322,38.21708,107,6.3,28
29000000,50041732,21041732,14.993169,103,6,27
32000000,48814909,16814909,24.147269,129,7,18
32000000,69055695,37055695,18.47242,107,6,28
35000000,21819348,-13180652,18.84332,90,5.7,35
32000000,83615414,51615414,15.901137,107,5.3,80
32000000,147332697,115332697,59.19888,93,7.1,53
32000000,36733909,4733909,14.48851,120,6.7,28
30000000,77566815,47566815,23.197408,101,6.3,53
33000000,9494789,-23505211,10.651202,105,6.7,12
35000000,31755742,-3244258,10.032626,113,5.6,28
0,0,0,6.048743,106,6.3,18
32000000,60740827,28740827,34.628738,96,6.9,18
32000000,85167639,53167639,47.5612,87,6.2,28
32000000,18552460,-13447540,16.473355,107,6.3,28
28000000,30016165,2016165,6.201404,90,5.6,28
32000000,0,-32000000,15.560918,121,6.6,18
32000000,18409891,-13590109,25.799697,111,6.2,28
70000000,53587404,-16412596,4.822033,90,4,14
32000000,0,-32000000,3.379454,110,5.4,14
30000000,27437881,-2562119,26.9385,100,5.3,35
32000000,3566637,-28433363,4.098444,75,7.1,16
0,0,0,4.901553,132,7.2,18
32000000,5914908,-26085092,5.347936,108,5.9,10752
32000000,0,-32000000,4.120549,93,5,12
31500000,89460381,57960381,49.973462,153,8,18
32000000,42045846,10045846,13.611544,102,6,35
0,106269971,106269971,6.775294,137,6.9,10402
31500000,14708696,-16791304,27.891012,113,5.7,28
31000000,128499205,97499205,13.864975,161,7,18
31000000,161772375,130772375,42.213765,138,6.5,18
34000000,210308099,176308099,29.887404,126,5.9,28
30000000,174600318,144600318,74.417456,99,8,35
31000000,24185781,-6814219,7.06762,101,6.4,18
31000000,53208180,22208180,15.895661,103,6.2,35
31000000,68106245,37106245,19.258041,118,7,80
31000000,104384188,73384188,47.753598,99,6.2,35
30250000,115101622,84851622,15.585138,105,6.4,35
45000000,306776732,261776732,32.217425,113,6.9,28
34200000,234801895,200601895,34.86859,93,6.1,35
30000000,287553595,257553595,36.432598,108,6,35
30000000,373554033,343554033,73.640445,81,7.7,16
30000000,350448145,320448145,49.526736,116,6.8,28
30000000,196114570,166114570,26.780961,104,7,18
31000000,15134293,-15865707,6.487344,105,6,18
30000000,136706683,106706683,25.996219,113,7.4,18
30000000,199200000,169200000,46.212155,134,7.2,28
25000000,115922175,90922175,32.105328,132,7.2,18
20000000,167722310,147722310,41.156217,92,6.2,35
30000000,191502426,161502426,37.179547,99,6.7,27
30000000,212385533,182385533,34.391792,90,6.1,80
37000000,165335153,128335153,40.176265,115,6.5,35
26000000,116400000,90400000,10.704596,102,6.5,35
33000000,327311859,294311859,79.579532,127,8.1,80
30000000,210819611,180819611,63.13678,112,7.3,878
30000000,140161792,110161792,27.870755,87,6.7,16
25000000,156822020,131822020,31.242999,138,7.6,53
30000000,216763646,186763646,70.456012,132,7.7,18
80000000,176885658,96885658,29.415229,103,6.4,35
29000000,115603229,86603229,55.109138,123,7.7,10749
30000000,160259319,130259319,30.695228,111,6.1,35
35000000,155545279,120545279,13.788422,102,6,35
30,103,73,4.590277,78,6,12
30000000,74787599,44787599,3.845231,132,5.9,18
30000000,160638883,130638883,26.952727,133,7.2,12
25000000,163670000,138670000,33.704181,109,6.7,18
30000000,105834556,75834556,19.925026,125,6.7,18
35000000,116980662,81980662,43.742241,97,6.4,27
30000000,47042000,17042000,46.377628,118,6.6,28
0,0,0,9.166658,87,4.9,14
30000000,254134910,224134910,34.36645,89,6,14
30000000,114281051,84281051,12.967137,100,5.8,18
30000000,105173115,75173115,50.670253,111,6.4,35
45000000,92374674,47374674,24.694551,109,6.7,28
30000000,63833449,33833449,11.409124,99,5.8,35
0,0,0,7.922716,114,5.8,18
30000000,114663461,84663461,33.385429,89,5.9,35
19000000,69631118,50631118,8.584398,95,5.3,28
37000000,96455697,59455697,41.569541,98,6.3,35
30000000,151119219,121119219,43.753585,94,7.4,14
0,0,0,18.568021,85,5.5,16
53000000,83282296,30282296,28.350529,124,7.4,80
80000000,118880016,38880016,10.81051,131,5.8,10749
30000000,70200000,40200000,19.578249,107,5.6,878
30000000,0,-30000000,5.73667,99,5.7,35
30000000,51132598,21132598,28.624038,83,6.3,35
30000000,152427960,122427960,27.230493,131,6,12
30000000,192452832,162452832,30.380747,85,6.8,12
30000000,156835339,126835339,29.489274,126,6.9,18
30000000,93772522,63772522,8.058109,102,5.1,35
30000000,129266061,99266061,33.369305,123,7.4,18
30000000,0,-30000000,16.52083,105,6.6,35
30000000,45892212,15892212,11.19602,125,6.2,28
30000000,54819301,24819301,14.585968,92,4.9,35
40000000,117195061,77195061,43.571612,77,7.2,10749
0,42647449,42647449,8.305085,118,7.2,18
30000000,84025816,54025816,55.424027,121,7.2,28
30000000,91709827,61709827,65.364452,123,7.3,28
30000000,90810892,60810892,45.083509,99,6.2,27
25000000,65663276,40663276,82.052056,112,7.4,14
0,0,0,15.011624,111,6.9,35
30000000,159291809,129291809,25.060342,107,6.6,18
25000000,51842679,26842679,11.42943,104,5.6,12
30000000,53653224,23653224,32.26789,113,7.1,35
30000000,75505973,45505973,33.394082,113,6.2,27
30000000,66486080,36486080,73.987775,95,6.5,27
30000000,84646831,54646831,10.608998,84,3.7,35
30000000,38413606,8413606,12.821329,126,7.2,12
27000000,38122105,11122105,30.131498,101,6.4,28
25000000,38748395,13748395,12.113235,94,6.6,27
30000000,63782078,33782078,31.191975,111,6.5,28
30000000,51376861,21376861,11.916389,95,3.8,28
30000000,36160375,6160375,20.355458,98,5.7,35
30000000,82394288,52394288,63.848541,100,5.8,18
30000000,34742066,4742066,8.999675,108,6.6,10402
30000000,41480851,11480851,9.278361,125,6.5,28
45000000,0,-45000000,7.185212,94,5.1,28
30000000,48428063,18428063,55.806402,79,6.6,28
30000000,63372757,33372757,48.237797,106,6.4,53
0,0,0,17.943945,111,5.9,35
30000000,14460000,-15540000,19.143721,63,6.8,16
19000000,39267515,20267515,15.67747,85,4.1,35
30000000,29202884,-797116,4.52363,108,6.3,35
0,31911598,31911598,13.064264,139,6.4,18
0,0,0,2.644427,127,6.2,18
30000000,24048000,-5952000,5.301589,106,5.4,28
0,60896147,60896147,20.252143,95,4.8,14
30000000,0,-30000000,29.359201,118,5.9,53
30000000,108609310,78609310,20.063165,108,5.8,28
35000000,22034832,-12965168,6.246199,111,5.2,35
30000000,53909751,23909751,27.71063,124,5.7,35
30000000,21800302,-8199698,2.850896,104,5,35
30000000,51148651,21148651,34.421696,133,6.9,10749
30000000,31070211,1070211,15.89534,87,4.8,878
30000000,35294470,5294470,18.706504,109,6,53
30000000,19204929,-10795071,9.607391,87,6,28
25000000,17193231,-7806769,2.77255,98,5.2,28
0,0,0,17.834976,99,5.4,28
30000000,102820008,72820008,20.236951,112,6.6,18
30000000,16930884,-13069116,16.883429,108,5.7,80
35000000,25224242,-9775758,12.779201,126,6.8,18
40000000,26155781,-13844219,14.729386,98,5.5,35
26000000,0,-26000000,23.227877,104,5.5,27
37000000,37962774,962774,11.374306,110,5.1,35
30000000,31148328,1148328,10.703602,130,6.3,53
30000000,15007991,-14992009,10.756266,97,5.1,28
30000000,15368897,-14631103,4.352422,96,5,35
30000000,13001257,-16998743,9.301562,114,6.7,18
17000000,24922237,7922237,18.27083,106,6,27
30000000,30536013,536013,19.106154,135,6.4,18
30000000,0,-30000000,5.259585,100,4,28
0,0,0,3.226243,100,5.4,18
100000000,0,-100000000,21.677732,85,2.9,28
30000000,0,-30000000,43.882857,107,5.7,28
25000000,30114487,5114487,12.10235,102,4.7,18
23000000,12,-22999988,3.362045,111,6.1,35
30000000,13521829,-16478171,10.694417,86,4.8,35
30000000,18618284,-11381716,6.353971,108,6.7,18
30000000,64352607,34352607,37.181019,123,6.3,12
30000000,8454301,-21545699,4.952735,134,7.2,35
30000000,62616646,32616646,22.975918,91,5.5,80
30000000,18195610,-11804390,8.359599,108,5.8,28
18000000,26828365,8828365,16.102271,122,7.4,10752
30000000,0,-30000000,49.336397,229,8.2,18
0,18074539,18074539,29.647844,118,5.9,53
0,0,0,12.467267,138,6.7,18
0,0,0,2.774811,108,6,80
0,3102550,3102550,3.71305,80,5.4,28
30000000,35078241,5078241,8.386432,92,6.3,18
0,0,0,3.866026,98,5,14
21000000,480314,-20519686,12.790408,87,5,12
30000000,14711793,-15288207,35.53352,160,7,28
30000000,108348,-29891652,4.065212,125,5,12
0,0,0,20.362025,91,5.9,35
30000000,0,-30000000,48.0343,92,5.4,53
30000000,2527904,-27472096,13.268936,129,6.4,28
0,0,0,8.010046,93,5.5,16
30000000,0,-30000000,12.257654,140,7,36
27000000,0,-27000000,6.036684,110,3,18
30000000,0,-30000000,10.958697,103,5.8,10749
30000000,0,-30000000,2.625594,85,6.4,14
30000000,0,-30000000,2.981047,110,6.6,80
19000000,140752617,121752617,66.242737,83,5.6,12
29000000,287506194,258506194,71.496894,115,6.8,35
28000000,186438883,158438883,35.580032,136,7.3,18
30000000,37036004,7036004,8.085872,127,5.9,35
29000000,0,-29000000,10.364582,86,5.8,12
0,0,0,16.87784,122,7.2,18
30000000,33013805,3013805,18.165957,113,6.6,35
29000000,16930185,-12069815,8.93941,100,5,35
29000000,78636257,49636257,20.55509,91,5.5,35
0,0,0,3.735723,157,6.9,18
0,0,0,4.310168,112,6.3,35
12000000,24829644,12829644,12.653831,87,4.9,18
29000000,21126225,-7873775,24.240361,103,6.8,18
28000000,504050219,476050219,92.982009,90,7.4,16
28000000,201634991,173634991,61.76233,147,7.7,18
28000000,333000000,305000000,66.976776,118,7.1,12
30000000,100491683,70491683,7.981116,79,5.7,16
60000000,105178561,45178561,21.252797,104,6.1,80
29000000,48902953,19902953,19.237254,110,6.6,35
29000000,98185582,69185582,27.555646,102,6.2,28
28000000,140767956,112767956,66.169628,131,7.5,28
28000000,92380927,64380927,24.917665,99,6.4,35
28000000,133346506,105346506,57.518472,130,7.3,35
0,0,0,11.870161,120,6.2,10402
28000000,64445708,36445708,7.534003,135,7,18
28000000,102356381,74356381,44.529429,101,6.8,14
35000000,94728529,59728529,14.949395,103,5.5,35
30000000,17137302,-12862698,14.726338,115,6.5,16
21000000,71441250,50441250,24.13081,110,7.4,35
30000000,90259536,60259536,45.915165,90,7.1,9648
28000000,134402450,106402450,28.043508,105,6.4,35
28000000,195312802,167312802,26.090746,127,6.3,12
28000000,77516304,49516304,14.530803,90,6.6,35
27000000,101646581,74646581,13.308127,99,5.5,53
28000000,60780981,32780981,38.0958,89,6.1,35
28000000,97594140,69594140,37.729059,115,6.9,10749
28000000,39514713,11514713,18.650748,96,6.4,35
28000000,92601050,64601050,15.794946,104,6.1,35
28000000,96188903,68188903,45.054936,117,7.1,28
28000000,40547440,12547440,25.039383,83,5.6,28
28000000,33000337,5000337,6.756771,99,4.6,53
28000000,100654149,72654149,22.14595,81,6.1,10751
28000000,121147947,93147947,36.58383,135,7.7,18
28000000,33139618,5139618,94.056131,117,7.9,878
28000000,31596911,3596911,10.703456,139,6.5,12
28000000,52597999,24597999,41.638961,113,6,28
21000000,54926886,33926886,14.518708,117,6.5,18
0,0,0,3.312385,97,4.5,27
35866397,20217080,-15649317,3.75074,98,7,99
28000000,38159905,10159905,22.074306,103,5.8,35
28000000,8888143,-19111857,4.436792,119,6,18
28000000,45236543,17236543,14.639324,94,5.5,28
28000000,8345056,-19654944,1.767479,86,5.5,12
28000000,14010832,-13989168,13.145205,98,4.8,28
28000000,7002261,-20997739,12.921594,108,5.8,35
28000000,16374328,-11625672,28.397048,108,5.5,10749
28000000,5684789,-22315211,7.039189,134,6.8,18
27000000,17286299,-9713701,16.785866,110,6.2,35
28000000,60700000,32700000,40.28635,103,6.3,28
24000000,23321954,-678046,6.009644,145,5.6,28
28000000,68896829,40896829,25.520976,90,5.7,28
27500000,187500000,160000000,25.633663,131,6.2,12
30000000,219076518,189076518,22.527211,129,6.2,35
30000000,95714875,65714875,24.09152,109,7.1,18
35000000,43650785,8650785,6.248273,114,5.7,35
8000000,27187653,19187653,9.548391,163,6.9,18
15000000,49469904,34469904,12.576381,92,6.9,18
27500000,24748670,-2751330,12.741073,120,6.2,18
27000000,96900000,69900000,16.188572,113,6.7,878
27000000,0,-27000000,5.576937,116,5.6,35
27000000,60527873,33527873,18.913,115,6.2,18
27000000,115229890,88229890,44.714264,133,7.5,10402
27000000,44352417,17352417,11.870301,117,6,12
0,0,0,5.753705,117,6.7,35
27000000,129000000,102000000,28.227984,101,6.6,18
27000000,56870414,29870414,11.678561,82,5.5,27
27000000,56308881,29308881,36.921445,110,7.4,18
27000000,21500000,-5500000,17.567332,193,7.3,18
30000000,15395087,-14604913,16.698316,130,6.3,18
27000000,20158808,-6841192,47.862016,102,7,18
27000000,27200316,200316,39.324831,100,7.2,9648
0,0,0,18.591657,110,6.7,18
25000000,11137801,-13862199,5.650125,109,6.7,12
27000000,76000000,49000000,3.123583,113,5.9,80
27000000,29000000,2000000,23.917982,109,6.1,27
27000000,13000000,-14000000,8.715822,99,5.5,80
0,0,0,5.737161,106,6.8,18
27000000,85564310,58564310,14.788073,89,4.4,10751
27000000,93282604,66282604,38.279458,98,6.5,53
28,14,-14,9.670031,93,5.9,53
0,4488529,4488529,5.271559,112,5.9,35
27000000,21148829,-5851171,17.193659,106,6.3,9648
25000000,6673422,-18326578,8.31653,104,5.2,35
0,0,0,2.653988,120,5.9,18
0,0,0,0.548435,133,6.9,35
26000000,183293131,157293131,31.250383,91,5.2,28
26000000,110230332,84230332,24.345651,97,6,35
26000000,109449237,83449237,38.473732,116,6.2,35
25000000,289317794,264317794,31.792964,122,6.8,10749
28000000,53181600,25181600,61.309619,113,6.2,80
15000000,201957688,186957688,5.411154,111,5.8,35
27000000,101624843,74624843,41.832392,111,6.6,28
26000000,65705772,39705772,21.988861,121,6.8,18
22000000,68296293,46296293,19.068175,139,7,37
26000000,61489265,35489265,24.114459,115,6.3,18
22000000,50750000,28750000,20.256571,175,6.9,18
26000000,57891803,31891803,8.802626,85,6.2,27
26000000,90426405,64426405,37.355826,90,5.9,27
26000000,71868327,45868327,39.742009,106,7.3,28
26000000,67918658,41918658,30.981604,100,5.2,27
25000000,86175291,61175291,31.893932,130,6.1,53
0,0,0,15.376391,109,5.9,35
26000000,38793283,12793283,5.894163,94,4.9,12
26000000,0,-26000000,10.981038,127,7.1,28
26000000,43318349,17318349,22.07638,104,6.8,18
26000000,28818995,2818995,10.925618,100,5.2,35
56000000,142044638,86044638,21.219292,118,5.7,35
42000000,35402320,-6597680,14.831402,118,5.8,18
26000000,29657751,3657751,22.520842,111,6.1,80
30000000,14000000,-16000000,3.314094,110,4.8,35
26000000,36800000,10800000,7.964451,99,4.5,28
26000000,0,-26000000,1.492056,101,5.5,80
26000000,0,-26000000,4.810621,100,6,14
0,0,0,9.317265,103,6.5,35
26000000,0,-26000000,5.644844,100,3.9,10749
25530000,20080020,-5449980,4.475007,95,5.3,12
26000000,30523226,4523226,66.097437,116,6.3,878
25000000,82466670,57466670,20.679652,129,6.8,18
30000000,611899420,581899420,38.171417,127,6.9,18
25000000,441286195,416286195,30.884535,125,7,35
25000000,412800000,387800000,49.510658,133,7.6,18
33000000,269958228,236958228,50.7453,116,7.8,18
25100000,29506464,4406464,10.445391,131,6.1,18
25000000,226830568,201830568,80.879032,93,7.2,28
26000000,35926213,9926213,33.93914,117,7.2,18
25000000,411006740,386006740,26.576385,129,6.1,53
22000000,321365567,299365567,104.469351,195,8.3,18
25000000,124272124,99272124,42.191509,146,7.8,18
28000000,8555008,-19444992,20.267062,128,5.7,18
0,181466833,181466833,22.644275,93,5.4,9648
26000000,0,-26000000,7.182761,127,4.9,53
30000000,114908830,84908830,26.69592,97,5.8,27
0,0,0,7.336256,100,4.7,53
25000000,80936232,55936232,12.739721,83,5.6,28
25000000,170764026,145764026,46.942396,85,6.4,28
25000000,78000000,53000000,15.505137,88,5.8,878
25000000,76270454,51270454,38.272889,119,7.6,80
25000000,171600000,146600000,53.645267,122,7.7,80
25000000,153997819,128997819,28.468,99,6.1,28
25000000,281929795,256929795,35.310712,97,6.5,35
25000000,152500343,127500343,28.727731,121,6.8,35
45000000,124914842,79914842,4.340616,95,5.1,35
25000000,119772232,94772232,14.604911,104,5.7,35
25000000,147780440,122780440,38.688822,107,6.1,35
25000000,56505065,31505065,30.537845,130,7.4,28
25000000,91036760,66036760,19.750059,115,6,28
2800000,60922980,58122980,25.939385,111,7.2,27
25000000,117719158,92719158,31.64341,93,5.8,27
25000000,99357138,74357138,26.811541,101,6.8,18
60000000,137587063,77587063,40.646102,96,7,12
25000000,116766556,91766556,34.160448,106,7.2,18
0,0,0,5.377155,100,7,35
25000000,77278331,52278331,48.552871,117,6.4,28
25000000,122644820,97644820,18.228538,101,6.1,27
26000000,90574188,64574188,29.342744,94,6.7,35
25000000,46836394,21836394,63.654244,145,8.2,18
28000000,58795814,30795814,11.859396,102,5,28
25000000,122489822,97489822,24.356483,97,6.4,14
25000000,65884703,40884703,70.105981,170,8,28
25000000,0,-25000000,8.618208,97,6.3,28
23000000,43984230,20984230,21.189028,163,7.4,18
25000000,63100000,38100000,31.364901,109,6.1,53
0,0,0,7.615653,97,5.9,28
25000000,77208711,52208711,37.817905,158,7.9,18
35000000,0,-35000000,5.784661,85,5.8,16
0,0,0,8.255708,84,5.6,16
25000000,41604473,16604473,6.086083,86,5.5,28
25000000,39053061,14053061,17.17372,119,6.3,18
25000000,64437847,39437847,16.936576,98,6.4,28
25000000,70442940,45442940,25.838073,97,5.6,10749
25000000,36351350,11351350,5.625632,105,5.4,35
25000000,38307627,13307627,17.312433,124,6.6,18
25000000,66980456,41980456,53.811461,94,6.4,18
0,0,0,7.057765,105,5.8,35
17000000,63102666,46102666,19.045146,104,5.5,27
25000000,59192128,34192128,21.729434,101,5.5,35
25000000,56489558,31489558,12.837116,101,5.8,28
25000000,41597830,16597830,20.953265,114,7,18
20000000,33889159,13889159,10.81439,105,6.4,35
25000000,229736344,204736344,27.683874,90,6.1,10751
20000000,70992898,50992898,9.855474,97,4.9,12
25500000,2415472,-23084528,12.756344,128,6,53
25000000,66122026,41122026,29.533437,114,7.1,18
30000000,82150642,52150642,14.179538,124,7.1,18
25000000,50671850,25671850,14.340095,89,5.5,27
25485000,29548291,4063291,9.795985,144,6.9,36
25000000,100000000,75000000,6.889437,93,4.7,12
25000000,34942188,9942188,19.428994,81,5.4,35
0,0,0,7.326034,83,4.7,28
25000000,28341469,3341469,136.747729,142,8.5,18
21150000,39438674,18288674,6.081772,92,4.7,12
27000000,25023434,-1976566,17.329269,113,6.7,35
25000000,39171130,14171130,22.622453,111,5.7,53
25000000,74188937,49188937,20.561682,121,6.9,35
25000000,27645491,2645491,13.288177,98,5.9,18
30000000,42886719,12886719,19.212552,107,6.5,35
23000000,46152800,23152800,29.365851,106,7.2,35
25000000,21567853,-3432147,10.232599,136,6.7,18
25000000,22200000,-2800000,8.870614,97,6.2,10749
25000000,114977104,89977104,19.402816,115,6.6,18
25000000,23580000,-1420000,24.903418,97,6.2,28
25000000,36993168,11993168,14.562197,99,5.4,14
25000000,40452643,15452643,18.896239,103,6,28
25000000,17000000,-8000000,15.960916,95,6.9,35
25000000,20796847,-4203153,25.848003,93,6.5,35
13000000,0,-13000000,6.337063,98,4.6,80
26000000,0,-26000000,10.006282,90,5.4,35
0,0,0,2.753501,107,4.7,18
0,0,0,6.718497,90,5,16
25000000,15431177,-9568823,7.538513,120,6.9,18
30000000,33333531,3333531,21.606001,115,5.4,53
8000000,0,-8000000,13.715715,91,5.6,18
25000000,24362772,-637228,3.707511,108,4.3,35
25000000,19829957,-5170043,7.001176,107,5.2,18
25000000,30411183,5411183,39.784026,108,6.3,35
25000000,51702483,26702483,10.115011,100,5.2,28
0,0,0,7.321181,85,4.4,28
25000000,42972994,17972994,32.854557,131,6.7,80
0,14334401,14334401,6.309587,88,6.3,28
28000000,10126458,-17873542,8.363702,91,4.9,27
25,13,-12,4.88794,145,7,18
25000000,28831145,3831145,14.17009,109,6.5,18
25000000,0,-25000000,12.18362,116,6.2,14
25000000,15478800,-9521200,9.169271,122,6.2,80
25000000,13411957,-11588043,8.127728,107,7,18
25000000,24902723,-97277,10.699952,120,6,18
25000000,11000000,-14000000,29.796394,99,7.1,28
0,0,0,11.60921,104,5.6,35
25000000,23057115,-1942885,51.915025,140,7.7,28
28000000,16900000,-11100000,8.314624,132,6.7,18
0,25000000,25000000,5.529035,254,6.6,10752
25000000,11207130,-13792870,4.002579,113,6.1,18
25000000,10719357,-14280643,3.888776,99,4.6,18
25000000,13000000,-12000000,7.296459,100,6.2,18
14000000,85446075,71446075,21.680424,92,5.8,27
25000000,10070000,-14930000,7.946769,105,5.3,35
25000000,10324441,-14675559,7.473455,110,5.5,18
25000000,11772461,-13227539,5.073536,116,6.4,35
0,0,0,3.623002,92,5.7,28
32000000,27635305,-4364695,41.075532,111,6.8,12
25000000,5778353,-19221647,4.020194,117,5,28
0,0,0,2.083856,95,5.5,28
25000000,0,-25000000,2.909346,95,4.8,35
25000000,0,-25000000,8.450513,127,7.3,18
25000000,4064495,-20935505,8.186936,98,5.5,28
0,0,0,5.079017,95,5.1,35
25000000,19844979,-5155021,17.603823,121,6.4,18
25000000,2405420,-22594580,7.008216,95,3.5,28
25000000,27603069,2603069,20.011435,80,7,35
25000000,0,-25000000,4.051221,107,5.9,18
0,34153101,34153101,5.987486,91,6.1,14
25000000,777423,-24222577,3.849873,117,6.2,18
25000000,2336172,-22663828,3.593165,114,6.6,35
13500000,19255873,5755873,30.058263,124,7.7,18
25000000,10589102,-14410898,17.339852,122,6,18
0,0,0,15.805449,88,5.6,16
25000000,48531470,23531470,15.279021,154,7.1,35
0,0,0,5.000126,117,6,18
0,0,0,1.684948,82,3.8,10751
25000000,6500000,-18500000,5.753564,85,6.3,10751
25000000,71009334,46009334,35.022029,117,5,53
25000000,0,-25000000,12.31708,121,6.2,10749
25000000,3052000,-21948000,1.894749,128,7,36
25000000,0,-25000000,6.895866,100,6.5,80
25000000,0,-25000000,3.344158,100,4.1,28
14000000,34670720,20670720,14.480628,119,7,18
25000000,8784318,-16215682,14.613152,137,5.5,12
24000000,133000000,109000000,22.258428,119,6.9,878
24000000,155721132,131721132,30.445257,102,6.5,18
24000000,172363301,148363301,35.244037,120,6.1,27
25000000,1397284,-23602716,15.333575,98,5.4,28
24000000,70181428,46181428,15.237142,105,6.4,35
41300000,106371651,65071651,23.441135,98,6.2,35
8200000,80035402,71835402,25.03414,107,6.4,18
24000000,87055349,63055349,24.70166,91,6.6,35
24000000,41895491,17895491,16.146572,137,7.2,35
65000000,40002112,-24997888,20.793026,100,5.1,27
24000000,36609995,12609995,5.771479,115,6.1,10749
24000000,42105111,18105111,27.326466,102,6.1,35
24000000,0,-24000000,3.572339,108,5.9,35
24000000,68729358,44729358,20.69219,93,5.9,35
0,0,0,1.903405,88,5.5,12
40000000,0,-40000000,10.713521,127,7.6,18
17000000,16980098,-19902,7.701041,95,5.5,35
24000000,16290976,-7709024,6.589193,87,5.8,14
24000000,21049053,-2950947,2.753313,134,5.9,12
24000000,12372410,-11627590,3.113009,107,4.7,28
24000000,8434146,-15565854,5.566203,124,5.7,35
24000000,30551495,6551495,8.630825,89,5,10749
24000000,83188165,59188165,23.343839,88,5.3,35
23000000,0,-23000000,6.138213,118,6.5,18
24000000,4562146,-19437854,2.353441,93,4.1,16
28000000,669276,-27330724,2.439184,72,6.8,12
0,0,0,0.515677,120,5.4,10749
24000000,23081726,-918274,26.324874,98,6.1,80
24000000,234710455,210710455,49.549984,119,8.2,14
23600000,102391382,78791382,57.300674,88,7.2,35
23000000,185991646,162991646,23.839127,90,5.9,35
18000000,538400000,520400000,78.51783,124,8.2,12
19000000,141407024,122407024,33.872182,118,6.5,28
23000000,86930411,63930411,27.33256,85,6.6,35
23000000,53302314,30302314,38.799596,98,6.4,27
12500000,75993061,63493061,20.317469,101,6.5,18
23000000,53187659,30187659,18.493202,108,6.7,53
23000000,0,-23000000,7.901891,97,6,35
23000000,47351251,24351251,53.682367,126,7.9,10749
23000000,36642838,13642838,11.183197,97,6.3,9648
25000000,6399,-24993601,8.842722,99,5.1,14
23000000,18653615,-4346385,8.976738,114,5.9,18
0,0,0,2.634119,88,6.4,28
23000000,33372606,10372606,26.257951,93,5.6,28
23000000,51881013,28881013,12.777008,89,3.5,12
0,0,0,6.130231,98,6.6,18
0,0,0,4.030724,94,6.5,18
23000000,10827816,-12172184,6.921263,102,6.6,18
23000000,7434726,-15565274,12.869436,98,6.1,28
23000000,29541790,6541790,15.676123,124,6.6,36
0,0,0,8.426589,110,6.6,18
11000000,0,-11000000,11.071522,90,5.8,37
23000000,9366227,-13633773,5.494047,86,5.9,18
23000000,16123851,-6876149,6.618149,141,5.5,18
23000000,5837674,-17162326,7.876883,139,6.5,18
25000000,94679598,69679598,35.169779,104,6.5,27
22700000,38119483,15419483,39.890798,96,6.7,35
22500000,15520023,-6979977,22.096286,112,6.8,10752
22000000,505000000,483000000,41.967005,127,6.9,14
23000000,369884651,346884651,57.110486,119,6.5,10749
22000000,189833357,167833357,16.234053,97,6.3,14
20000000,75597042,55597042,11.263361,127,6.5,18
22000000,147880543,125880543,20.699212,110,6,35
24000000,182016617,158016617,17.606087,135,7.3,18
22000000,84772742,62772742,13.786075,84,4.6,28
22000000,77737889,55737889,35.227212,191,7.4,18
22000000,88880821,66880821,27.898438,122,7.3,18
22000000,110627965,88627965,23.218144,114,5.6,80
22000000,92542418,70542418,26.071644,132,7.2,18
22000000,67800064,45800064,9.175762,138,5.9,18
22000000,95708457,73708457,81.829237,121,6.6,14
22000000,57479076,35479076,17.7091,108,6.1,18
22000000,35424826,13424826,17.772518,108,6,18
22000000,0,-22000000,5.609755,131,6.8,18
22000000,22400154,400154,10.259461,83,4.7,35
26000000,51164106,25164106,30.114383,105,6.2,35
0,9930095,9930095,10.547959,108,6,53
22000000,19351569,-2648431,12.887673,90,5.4,35
22000000,77112176,55112176,13.410919,94,6,35
0,0,0,3.70789,142,6.3,53
22000000,33788161,11788161,21.865021,104,6.4,35
30000000,23619609,-6380391,9.448517,106,5.4,18
22000000,63647656,41647656,39.006187,106,5.7,35
22000000,0,-22000000,6.404571,98,5.3,35
22000000,43058898,21058898,35.737655,100,6.4,28
22000000,13555988,-8444012,4.365196,95,6.1,10751
22000000,0,-22000000,14.925633,106,6.2,35
22000000,10696210,-11303790,14.725467,104,4.2,28
0,0,0,0.809588,104,3.6,28
0,0,0,0.816883,107,4.9,18
70000000,0,-70000000,8.792054,77,3.8,35
25000000,72629670,47629670,25.002715,96,5.2,53
0,0,0,7.588597,114,5.9,18
21000000,26193068,5193068,13.906611,145,7.2,18
22000000,17709155,-4290845,13.960945,116,7.2,10749
2000000,14400000,12400000,16.668854,100,5.5,28
0,0,0,6.847133,104,5.9,28
22000000,15447154,-6552846,48.784734,92,6.2,9648
22000000,12000000,-10000000,9.088209,121,7.4,28
22000000,9479718,-12520282,12.445176,105,5.2,18
0,0,0,4.61335,115,6.7,10749
22000000,15400000,-6600000,29.230298,116,6.5,53
25000000,92991835,67991835,18.961323,119,6.5,18
0,0,0,2.809378,101,6.3,35
21500000,0,-21500000,12.819447,117,7,18
22000000,24000000,2000000,14.866351,106,6,16
17000000,73244881,56244881,15.013386,111,5.6,10749
18000000,70687344,52687344,8.700565,136,5.5,878
21000000,0,-21000000,27.197799,81,7.1,16
9000000,46,-8999954,20.410354,90,6.9,35
21000000,42000000,21000000,10.207065,96,5.1,28
32000000,40222729,8222729,5.683281,106,6.3,35
21000000,205738714,184738714,63.599973,122,6.9,18
21000000,41170784,20170784,17.746981,123,7.5,80
0,37000000,37000000,1.934524,134,7,18
21000000,43928932,22928932,34.433521,92,6.6,28
20000000,41627431,21627431,26.21425,115,6.4,18
21000000,17762705,-3237295,4.781538,104,5.1,27
17000000,14899417,-2100583,10.13559,98,6.7,18
21000000,17600000,-3400000,5.815881,120,5.8,18
21000000,10011050,-10988950,8.982335,117,6.5,10749
30000000,0,-30000000,33.649652,127,6.6,18
0,0,0,2.636193,102,5.5,18
21000000,970816,-20029184,13.847872,91,6.3,18
35000000,69701637,34701637,4.189378,114,5.9,35
15000000,2856712,-12143288,21.928025,97,6.7,28
18000000,389925971,371925971,68.159596,115,7.7,12
18000000,358991681,340991681,81.487685,120,6.3,35
20000000,303788635,283788635,52.456505,135,7.2,878
38000000,29907685,-8092315,9.662715,90,5,27
20000000,299965036,279965036,25.28436,100,6.1,28
20000000,132675402,112675402,8.351385,105,5.4,35
19000000,272742922,253742922,18.174804,119,8.1,80
20000000,121697323,101697323,21.815122,94,6.5,10402
20000000,117224271,97224271,20.99174,94,6.4,35
20000000,187884007,167884007,19.636044,116,5.9,27
20000000,149281606,129281606,12.25264,91,4.9,12
13000000,318000141,305000141,49.975409,112,7.4,27
32000000,97918663,65918663,13.590677,95,5.2,12
20000000,100525432,80525432,21.657563,97,5,35
35000000,131282949,96282949,43.057323,108,6.7,35
18000000,122195920,104195920,16.470895,101,5.4,28
37000000,113086475,76086475,28.703007,109,6.3,35
20000000,177243185,157243185,40.903931,115,6.7,35
20000000,0,-20000000,22.001408,117,6.7,12
0,0,0,23.139971,107,6.9,18
20000000,187000000,167000000,95.9229,134,7.9,18
20000000,57588485,37588485,4.748929,118,6.2,18
20000000,60072596,40072596,2.986286,121,6.1,35
20000000,53000000,33000000,47.51363,105,7.5,14
20000000,207945075,187945075,53.161905,110,7.6,18
0,0,0,7.050951,114,5.9,18
1800000,41158757,39358757,15.978136,104,7.4,28
20000000,183936074,163936074,42.512296,100,6.3,35
20000000,48548426,28548426,10.098722,83,3.6,35
20000000,109862682,89862682,15.341196,72,6.1,12
20000000,66787908,46787908,29.023184,127,7.4,36
20000000,135680000,115680000,19.819893,72,5.6,10751
20000000,67192859,47192859,11.62423,89,4.6,53
20000000,84146832,64146832,22.049787,96,5.8,53
30000000,45554533,15554533,9.829859,77,6.3,16
20000000,41596251,21596251,29.295801,123,6.7,27
20000000,43967255,23967255,14.136476,111,6.8,12
20000000,86865564,66865564,6.064638,86,3.2,28
20000000,88346473,68346473,41.503588,128,7.8,18
20000000,27640028,7640028,20.495749,110,5.9,18
20000000,39143839,19143839,13.906944,102,5.2,27
20000000,37672350,17672350,2.003047,124,6,35
0,0,0,11.349664,98,5.9,12
20000000,41237648,21237648,11.203335,115,5.8,35
20000000,35841901,15841901,8.265317,98,6.1,12
20000000,65464324,45464324,18.632156,104,5.8,80
20000000,60000000,40000000,6.92592,127,7,18
20000000,80547866,60547866,17.165039,82,4.2,27
25000000,135330182,110330182,25.785925,143,6.9,18
19800000,41296320,21496320,20.311684,103,6.5,18
20000000,50907234,30907234,20.975165,104,7,18
32000000,50907422,18907422,26.509175,98,6.6,10402
20000000,47241945,27241945,26.497025,92,5.3,27
0,0,0,14.211699,124,6.4,18
20000000,78378744,58378744,36.819044,86,4.6,35
20000000,31678778,11678778,7.902536,158,6.2,18
20000000,54586584,34586584,30.909699,128,7.1,36
20000000,46069568,26069568,16.663797,107,5.7,28
35000000,68349884,33349884,27.724913,91,5.3,27
19000000,35387212,16387212,17.971883,108,6,35
20000000,67200000,47200000,25.041992,108,6.3,80
0,0,0,7.924428,101,5.4,27
20000000,45636368,25636368,14.857884,113,6.3,18
30000000,47126295,17126295,23.982956,113,7,35
20000000,0,-20000000,12.458131,87,4.7,27
20000000,0,-20000000,3.996392,101,5.8,18
20000000,64822796,44822796,30.387754,112,6.6,53
20000000,72258126,52258126,56.481487,108,7.9,878
20000000,32005248,12005248,19.962713,105,6,35
20000000,65569869,45569869,18.666876,109,6.3,28
20000000,46089287,26089287,55.964605,109,6.7,35
0,0,0,5.0348,99,5.8,28
20000000,51416464,31416464,28.019226,98,6,14
20000000,49779728,29779728,16.176976,104,5.9,35
20000000,17425000,-2575000,17.237143,109,6,12
9000000,27105095,18105095,4.34503,100,5.3,27
0,0,0,11.360997,119,6.5,10749
20000000,39300000,19300000,12.300789,88,5.3,10751
20000000,37597471,17597471,15.804814,97,5.2,28
0,0,0,9.750557,105,6.3,35
40000000,28972508,-11027492,4.100942,89,5.1,35
20000000,21284514,1284514,12.309715,106,6.7,14
20000000,83707310,63707310,62.933899,96,7.1,9648
20000000,20211394,211394,16.074397,115,6.3,18
20000000,0,-20000000,17.016284,108,5.8,28
806948,32000000,31193052,93.067866,109,8.2,18
20000000,36620508,16620508,17.145287,101,5.4,10749
20000000,34077920,14077920,27.256849,103,6.7,18
20000000,0,-20000000,7.878177,113,5.6,35
20000000,2297493,-17702507,0.173964,98,4.9,35
20000000,18432000,-1568000,14.370111,121,6.8,12
20000000,18253415,-1746585,11.090254,114,6.5,35
20000000,22222308,2222308,20.82778,124,7.1,18
15000000,56255142,41255142,43.644978,148,7.8,12
20000000,17807569,-2192431,8.244324,100,5.6,35
20000000,52302796,32302796,23.292761,94,5,53
19000000,25836616,6836616,64.181668,108,6.9,27
0,0,0,9.03154,68,6.4,16
0,17519169,17519169,4.031585,103,6.3,35
20000000,100914445,80914445,13.658985,99,7.2,28
35000000,0,-35000000,6.908351,88,4.3,12
20000000,73276047,53276047,10.446722,128,7.3,18
20000000,60427839,40427839,32.243357,124,7.2,18
20000000,16605763,-3394237,9.149089,84,5.8,28
20000000,17432163,-2567837,5.596835,101,5.3,35
0,0,0,5.214408,98,5,18
20000000,17436509,-2563491,10.50098,120,7,99
20000000,15473333,-4526667,3.011205,199,6.5,18
19500000,34854990,15354990,15.012237,111,6.2,80
25000000,14109284,-10890716,16.238961,87,3,28
20000000,22942221,2942221,15.21229,88,5.5,28
20000000,13801755,-6198245,6.397042,97,6.5,35
20000000,30426096,10426096,19.220789,106,6.2,35
20000000,32204030,12204030,35.232278,95,5.8,28
40000000,0,-40000000,9.842771,99,4.8,35
20000000,34560577,14560577,35.542809,96,5.9,28
0,0,0,7.829295,98,7,28
20000000,13391174,-6608826,3.476925,123,6.1,18
30000000,27674124,-2325876,5.133744,101,6.4,18
20000000,12482775,-7517225,14.031377,101,6,35
20000000,12398628,-7601372,17.227376,96,6.1,28
0,0,0,17.98817,102,6.4,35
20000000,17280326,-2719674,15.66135,108,5.7,28
20000000,24145613,4145613,19.705311,116,6.7,18
0,0,0,2.645722,93,4.5,12
0,0,0,17.662683,102,6.2,18
0,0,0,2.894154,103,6.4,35
20000000,12639297,-7360703,29.371987,115,5.6,28
20000000,10686841,-9313159,11.352693,96,7.3,35
20000000,0,-20000000,7.553773,98,5.4,35
20000000,36606743,16606743,30.477114,100,6.3,18
20000000,0,-20000000,9.927018,106,5.6,35
20000000,0,-20000000,12.379781,101,6.5,10402
20000000,16974459,-3025541,12.643703,105,6.5,28
21000000,0,-21000000,15.440465,99,6.5,18
0,9109322,9109322,5.886228,88,1.9,35
0,12382362,12382362,6.925645,83,5.4,28
20000000,10337477,-9662523,9.36146,84,4.7,28
20000000,11341016,-8658984,6.102663,98,6.4,35
8000000,20000000,12000000,0.709143,149,6.5,35
20000000,11110975,-8889025,45.742217,148,6.5,35
0,0,0,1.682839,85,3.2,10751
20000000,16549477,-3450523,8.237336,110,5.9,10402
20000000,7000000,-13000000,2.605374,83,4.1,35
12000000,15008161,3008161,29.072964,107,5.3,28
22000000,0,-22000000,1.322528,100,5.8,27
0,6575282,6575282,4.961306,87,4.7,35
0,0,0,8.628519,160,6.7,35
20000000,6420319,-13579681,12.232048,106,7,35
15000000,27462041,12462041,27.133277,99,6.2,18
8700000,7659918,-1040082,26.093043,100,6.8,16
0,0,0,13.621201,117,7,18
20000000,10442808,-9557192,9.292987,96,3.1,28
20000000,5210988,-14789012,7.716606,111,5.4,35
20000000,0,-20000000,7.698075,100,5.9,18
20000000,12007070,-7992930,37.629309,125,6.5,80
0,0,0,2.405911,114,6.3,18
0,0,0,3.350297,119,6.3,18
20000000,4001121,-15998879,13.032308,135,6.6,18
20000000,16863583,-3136417,15.131867,93,4.8,28
20000000,5530764,-14469236,10.218307,114,6.8,12
21000000,0,-21000000,12.761176,124,7.4,18
26500000,159375308,132875308,60.732738,134,8.2,12
0,0,0,0.49446,114,5.7,35
0,0,0,6.574285,124,4.9,35
2000000,5048693,3048693,14.617944,104,7.1,28
20000000,0,-20000000,3.102987,118,6.8,18
20000000,1675706,-18324294,5.65327,84,3.3,35
20000000,5359645,-14640355,44.566609,107,6.9,28
40000000,7400000,-32600000,8.978408,125,6.5,18
0,0,0,10.150993,115,6,18
0,0,0,0.28576,88,2.2,10751
10000000,3727746,-6272254,11.267676,122,5.4,18
20000000,0,-20000000,9.129808,126,6.4,16
0,0,0,2.013405,101,5.8,18
0,0,0,20.086645,101,5.9,18
20000000,305070,-19694930,3.581906,107,6.2,12
0,47301471,47301471,12.373248,86,6.1,35
0,0,0,12.283025,118,5.8,35
20000000,4634062,-15365938,10.617236,107,4.5,28
20000000,0,-20000000,6.377308,100,5.5,18
20000000,346594,-19653406,3.620537,110,6,18
0,17671101,17671101,27.215666,106,5.3,27
0,0,0,4.127155,102,6.6,28
20000000,0,-20000000,13.118983,95,6.3,80
20000000,0,-20000000,14.182301,83,5.3,35
0,0,0,0.416179,170,5,18
0,0,0,0.485405,98,0.5,16
20000000,0,-20000000,7.444189,105,6.1,18
20000000,0,-20000000,33.625477,96,5.4,53
27220000,5496951,-21723049,28.060472,105,6.1,53
19400000,0,-19400000,20.746932,125,7.1,18
27000000,0,-27000000,7.727035,150,7.1,28
22000000,424208848,402208848,45.707835,181,7.6,12
20000000,216197492,196197492,28.497242,92,5.4,35
19000000,110879513,91879513,11.47316,113,6.7,18
19000000,70067909,51067909,25.28132,95,6.1,35
14000000,173046663,159046663,45.99611,111,7,80
0,0,0,20.392858,91,5.4,27
19000000,44017374,25017374,78.699993,144,8.1,27
19000000,381109762,362109762,76.603233,116,8,12
19000000,40846082,21846082,13.664614,93,5.5,27
0,0,0,2.242809,113,6,18
27000000,0,-27000000,1.224105,90,3.9,28
19000000,49830607,30830607,27.494037,101,5.9,35
18000000,101564935,83564935,18.47518,95,5.3,35
19100000,5728213,-13371787,10.559414,109,6.5,18
0,0,0,1.916351,85,4.6,16
20000000,54956140,34956140,28.867568,101,6.2,9648
15000000,274925095,259925095,118.968562,125,8.3,14
0,0,0,3.376967,110,5.9,28
25000000,8613462,-16386538,7.436491,132,6.5,28
0,76586316,76586316,57.84156,131,7.4,18
19000000,18755936,-244064,17.952817,109,6,35
19000000,29922472,10922472,21.959742,100,6.4,10749
19000000,4750000,-14250000,4.229942,188,6,18
19000000,6928068,-12071932,11.766564,97,6.2,35
0,5310554,5310554,2.366251,121,5.8,18
19000000,2119994,-16880006,0.068228,93,5.6,10751
18000000,0,-18000000,5.380733,116,6.1,53
0,0,0,5.625989,110,6.8,18
19000000,108047131,89047131,30.205943,90,6,27
19000000,32801173,13801173,26.441669,114,7.3,35
15000000,46770602,31770602,15.262492,93,6,27
0,0,0,1.583918,107,5.8,28
18500000,10680275,-7819725,44.511363,118,7.2,12
18500000,31912793,13412793,16.665841,100,6,35
18000000,268157400,250157400,36.471231,96,6.2,35
23000000,351583407,328583407,85.30318,101,6.6,10749
18000000,151668774,133668774,20.716023,104,6.9,14
18000000,261572744,243572744,29.487784,82,6.5,35
18000000,141774679,123774679,25.43954,96,6.1,35
18000000,87000000,69000000,15.314027,105,6.4,878
19000000,144216468,125216468,32.602868,122,6.3,80
17000000,65535067,48535067,9.832326,88,5.5,35
16000000,19682924,3682924,33.452469,110,3.7,53
0,0,0,14.190837,103,6.2,35
18000000,65070412,47070412,6.501815,106,5.6,35
23000000,76488889,53488889,26.58873,91,6.5,18
16500000,67683989,51183989,36.15716,94,6.5,878
18000000,88923251,70923251,16.027955,94,5.5,10749
21000000,72417394,51417394,14.329891,99,6.3,10751
18000000,98235548,80235548,50.009408,107,7.3,878
18000000,51973029,33973029,31.82675,160,7.8,18
0,14796236,14796236,9.642041,88,4.8,80
17000000,129042871,112042871,36.423717,97,6.9,35
0,0,0,12.309718,113,6.4,35
19800000,87754044,67954044,11.693272,137,6.8,18
18000000,41382841,23382841,12.243887,103,5.9,35
18000000,103215094,85215094,89.811154,119,7.4,18
18000000,99206215,81206215,34.694216,98,7,35
15000000,76286096,61286096,17.50138,111,6.9,18
18000000,62646763,44646763,18.492655,94,6,10749
18000000,0,-18000000,11.238522,81,4.9,28
1000000,21378361,20378361,14.518598,89,6.4,27
18000000,47088990,29088990,19.234672,106,6.9,28
18000000,24911670,6911670,4.504377,121,6.7,10752
0,24007324,24007324,10.529143,86,5.6,35
18000000,100000000,82000000,18.379124,103,5.8,12
18000000,23000000,5000000,35.524457,129,7.7,18
18000000,36133014,18133014,13.472365,109,5.6,18
18000000,0,-18000000,8.321586,109,6.7,28
0,0,0,7.668063,107,5.5,10402
18000000,35692920,17692920,52.464877,94,7,12
0,0,0,11.423533,94,6.4,28
18000000,17200925,-799075,6.961736,115,6.8,18
17000000,24000000,7000000,9.191187,107,5.4,35
18000000,16702864,-1297136,4.492859,92,4.9,10751
18000000,0,-18000000,5.706767,125,7.2,18
30000000,34441873,4441873,53.670525,122,6.8,18
18000000,0,-18000000,14.15192,102,5.1,35
18000000,0,-18000000,13.462544,87,5.9,18
18000000,2945600,-15054400,11.725805,98,3.7,28
21000000,28008462,7008462,7.047975,109,6.2,18
18000000,12000000,-6000000,13.628601,108,7.3,18
18000000,10501938,-7498062,16.520516,90,4.9,28
18000000,8038061,-9961939,14.916264,112,6.9,18
18000000,25312387,7312387,9.633711,94,5.7,35
0,0,0,3.455018,105,5.6,12
0,0,0,1.946634,104,6.4,35
17000000,6735922,-10264078,12.313143,117,5.8,18
18000000,14110013,-3889987,3.258422,108,6.5,14
0,0,0,3.659292,112,6.7,18
18000000,5887457,-12112543,24.548633,127,7.3,35
18000000,20275812,2275812,17.683563,111,6.7,18
18000000,26527510,8527510,10.1449,120,6.5,36
18000000,25739015,7739015,31.887978,114,6.9,28
0,0,0,1.110179,99,3.5,12
0,0,0,9.814785,242,7.3,18
25000000,20719451,-4280549,1.876811,117,6.8,18
18000000,6212282,-11787718,32.717853,112,6.2,12
0,0,0,8.945081,108,6.2,35
18000000,22309223,4309223,13.916583,116,6.7,18
15238800,0,-15238800,17.94739,144,7.2,80
0,0,0,2.525569,90,5.3,27
2700000,3500000,800000,10.47644,93,5.9,10749
18000000,676698,-17323302,10.991281,103,7,18
18000000,7972967,-10027033,7.871686,93,6.7,10402
18000000,382174,-17617826,6.333869,98,4.4,18
18000000,871279,-17128721,1.138383,338,6.7,80
18000000,0,-18000000,8.266124,114,5.6,53
0,0,0,0.910529,121,9.3,37
3500000,34000000,30500000,18.025206,96,6.9,27
18000000,0,-18000000,10.144222,92,4.5,28
18000000,1831348,-16168652,9.244181,105,6.7,28
17900000,6948633,-10951367,12.752463,89,5,12
14000000,13551174,-448826,22.748174,119,6,53
20000000,121463226,101463226,33.436092,113,7,35
0,90508336,90508336,3.107371,103,6.4,35
18000000,0,-18000000,7.922639,90,5.7,27
23000000,150816700,127816700,28.973074,98,6.5,10402
15000000,51053787,36053787,23.980329,80,5.9,16
17500000,38000000,20500000,28.60542,121,7.5,18
24000000,99965753,75965753,42.669304,89,5.9,28
17500000,7018189,-10481811,7.180403,93,5.8,18
18000000,266586800,248586800,21.638673,93,4.6,53
0,0,0,2.64486,116,5.4,53
0,0,0,25.881355,101,7.4,27
18500000,183316455,164816455,67.66094,137,7.7,27
17000000,72070731,55070731,20.786616,170,7.4,18
17000000,125586134,108586134,27.654472,100,5.6,27
17000000,136621271,119621271,70.668923,104,6.4,35
16000000,109502303,93502303,23.425431,126,6.9,35
17500000,19179969,1679969,14.304444,110,5.8,35
300000,70000000,69700000,30.301307,91,7.4,27
17000000,0,-17000000,3.56033,87,4.7,35
17000000,71625195,54625195,7.210095,123,6.7,35
17000000,57103895,40103895,23.491962,109,6.4,28
20000000,136150434,116150434,36.133536,90,5.8,27
17000000,0,-17000000,14.18136,94,5.2,35
17000000,30331165,13331165,12.709227,81,5.9,35
17000000,43165571,26165571,24.054062,86,6,18
15000000,69623713,54623713,35.107857,107,6.1,27
0,0,0,10.149569,98,5.1,35
0,45710059,45710059,14.023082,128,7.4,18
0,0,0,9.054803,99,5.6,35
20000000,21170563,1170563,5.422285,105,6,18
17000000,115350426,98350426,32.746486,112,7.3,35
34000000,19693891,-14306109,3.960098,108,4.8,18
0,0,0,10.178917,121,6.9,18
17000000,0,-17000000,4.544216,89,4.6,27
0,0,0,2.184708,89,3.3,35
0,0,0,3.09159,73,6.3,10751
17000000,29536299,12536299,18.790102,133,6.2,80
17000000,10000000,-7000000,3.321095,154,6.3,28
17000000,97542952,80542952,33.912116,91,6.4,27
17000000,20455276,3455276,5.787891,95,5.6,35
17000000,7314027,-9685973,7.864011,107,4.9,35
17000000,19300000,2300000,17.062117,90,4.1,28
0,0,0,1.782666,94,3,18
17000000,9500000,-7500000,19.311572,122,7,28
0,0,0,2.897449,120,5.5,18
17000000,0,-17000000,0.138564,97,2.9,12
40000000,86915017,46915017,36.960953,110,7.1,14
17000000,2000000,-15000000,1.15641,102,5.6,12
17000000,1569918,-15430082,9.583578,98,6.8,18
17000000,3758328,-13241672,25.112567,120,6.1,53
17000000,374743,-16625257,9.349386,144,5.2,28
15000000,0,-15000000,8.884405,80,6.5,16
17000000,8720000,-8280000,2.215261,91,5,28
17000000,9627492,-7372508,6.385234,82,4.5,27
16500000,0,-16500000,20.935169,102,7,35
16800000,2281089,-14518911,4.358255,122,5.8,18
15000000,43848069,28848069,24.898687,126,7,80
16500000,135000000,118500000,20.898711,136,7.2,18
16500000,37311672,20811672,18.236284,120,6.9,18
16500000,13620075,-2879925,10.74648,108,6,35
16500000,16942795,442795,12.102725,126,7,18
16400000,235860116,219460116,55.458584,129,8.1,18
16000000,247275374,231275374,35.777067,107,6.5,35
16000000,92823546,76823546,18.430419,96,7.3,35
16000000,53977250,37977250,7.980632,129,7.4,18
16000000,119754278,103754278,14.759948,93,5.9,35
0,0,0,9.229999,106,6,35
15000000,133432856,118432856,29.943316,100,7.3,18
16000000,76514050,60514050,15.788784,87,4.8,27
16000000,68263166,52263166,41.083914,94,7.6,35
16000000,0,-16000000,21.380635,91,5.9,27
18500000,6490401,-12009599,1.884558,120,6.4,18
0,0,0,4.382761,80,3.7,35
19000000,83258226,64258226,90.809408,118,7.6,14
0,0,0,6.579017,94,4.8,28
16000000,29381649,13381649,7.854989,130,7.4,80
16000000,40492759,24492759,11.807269,91,5.3,53
17700000,30987695,13287695,15.976335,91,5.5,9648
15000000,30102717,15102717,10.484642,110,5.3,53
12000000,80573774,68573774,38.623178,121,7.4,80
16000000,50007546,34007546,8.8321,114,4.6,35
15000000,96408652,81408652,32.758254,96,6.7,18
25000000,0,-25000000,6.091033,139,6.4,28
16000000,20627372,4627372,9.119797,94,5.4,35
0,0,0,9.423866,109,7.2,18
16000000,31556061,15556061,32.257414,100,5.3,35
16000000,15427192,-572808,3.021835,96,5.4,35
16000000,0,-16000000,7.612849,90,7,35
20000000,0,-20000000,36.764666,113,6.9,18
0,0,0,3.199784,99,5.7,18
20000000,13854000,-6146000,9.455596,108,5.3,35
26000000,206678440,180678440,44.301745,125,7.6,18
16000000,18564088,2564088,19.890428,100,6.8,53
16000000,12,-15999988,0.830596,97,4.6,35
0,0,0,2.637355,107,5.1,28
0,0,0,2.25453,112,5.5,35
16000000,0,-16000000,8.711782,112,6.4,35
6500000,4217115,-2282885,5.700333,95,6.7,35
16000000,5900000,-10100000,29.253833,116,6.8,12
16000000,2849142,-13150858,8.842869,113,6.7,18
16000000,1686429,-14313571,2.848727,97,4.3,878
16000000,5867686,-10132314,13.832464,117,6.2,18
0,0,0,4.488547,135,6.9,18
20000000,24261569,4261569,38.802415,101,6.5,53
16000000,14822346,-1177654,9.400404,86,4.7,10749
11000000,53191886,42191886,18.923181,106,6.8,35
0,0,0,2.397987,96,6.3,18
13000000,754249,-12245751,20.39955,161,7.2,14
16000000,0,-16000000,7.251897,93,4.8,35
16000000,47801389,31801389,43.217089,93,7.7,18
16000000,0,-16000000,14.529496,110,6.7,80
16000000,3442853,-12557147,20.59148,122,6.4,37
15600000,0,-15600000,2.244947,91,4.2,35
0,0,0,1.326264,115,5.7,10752
0,0,0,0.212108,99,5.3,28
15500000,1237615,-14262385,6.630856,93,5.5,9648
15300000,0,-15300000,18.20957,94,6.2,18
15500000,0,-15500000,17.327279,95,6.3,35
15000000,316360478,301360478,29.843818,105,6.8,28
18000000,476684675,458684675,2.186927,103,7.1,35
0,0,0,12.335827,102,5.8,10751
21000000,177200000,156200000,20.818567,116,6.9,35
15000000,356830601,341830601,58.900647,110,6.7,28
17000000,213525736,196525736,45.742254,120,7.2,12
15000000,356296601,341296601,80.878605,122,7.9,18
15000000,414211549,399211549,54.053576,118,7.6,18
15000000,216614388,201614388,17.638286,107,5.7,35
15000000,317000,-14683000,3.803495,102,6.4,18
15000000,146292009,131292009,17.571533,154,7.7,18
16000000,11301649,-4698351,4.628525,120,6.5,28
14000000,233555708,219555708,145.364591,113,8,36
0,0,0,12.18838,109,6,35
15000000,67182787,52182787,3.826685,125,7.2,18
15000000,75700498,60700498,21.095489,92,5.9,35
15000000,146497771,131497771,47.455148,100,6,27
15000000,61399552,46399552,22.838834,98,7.1,35
15000000,151831537,136831537,27.165222,92,6,35
15000000,123384128,108384128,19.113278,103,6.8,18
15000000,73326666,58326666,58.553213,92,7.1,14
15000000,55184721,40184721,2.005111,113,6.1,35
18000000,0,-18000000,16.418639,115,7,18
17000000,127730736,110730736,43.675191,95,6.1,18
15000000,66966987,51966987,4.688212,87,5.4,27
15000000,52970014,37970014,9.125594,88,5.6,35
15000000,50000000,35000000,19.786392,183,7.8,18
15000000,64256513,49256513,13.581966,97,6.7,35
17000000,55534455,38534455,11.927667,94,5.7,10751
35000000,42930462,7930462,30.556135,112,5.8,53
15000000,61548707,46548707,31.565117,98,5.9,27
15000000,40283321,25283321,21.535126,104,6.2,27
0,0,0,7.921311,118,6.9,18
15000000,44862187,29862187,19.284129,104,6.6,28
16000000,66468332,50468332,23.423082,89,5.5,35
7000000,48126384,41126384,49.517264,109,7.2,80
15000000,35007180,20007180,11.375032,106,5.8,80
15000000,123726688,108726688,61.182331,123,7.8,18
0,0,0,7.314796,86,4.7,35
15000000,33771174,18771174,6.857923,120,6.9,35
15000000,69995385,54995385,41.286336,216,7.8,12
15000000,39421467,24421467,12.929525,105,5.1,27
15000000,52501541,37501541,42.952942,115,7,18
15000000,32721635,17721635,19.760383,110,6.2,80
15000000,47175038,32175038,10.194097,88,6.2,35
13000000,37664855,24664855,11.045593,94,4.5,27
16000000,30857814,14857814,44.533612,98,7.6,12
15000000,30226144,15226144,10.84158,126,6.9,18
15000000,78054825,63054825,49.294864,100,7.4,18
15000000,29331068,14331068,7.424798,89,5.1,35
15000000,46905889,31905889,5.164281,111,5.6,35
15000000,64238440,49238440,34.759855,100,6.5,27
15000000,30127963,15127963,7.297757,115,6.3,18
14000000,32645546,18645546,3.334804,106,6.1,35
20000000,27728118,7728118,2.027393,124,7.4,28
0,28084357,28084357,13.817269,107,6.9,28
15000000,40105542,25105542,13.237835,99,4.7,35
0,0,0,3.890223,90,4.3,9648
15000000,24769466,9769466,19.517239,101,6.3,18
15000000,85306374,70306374,30.669913,124,7.3,18
0,0,0,9.681147,103,6.1,35
11500000,23237911,11737911,15.355589,134,7.5,18
15000000,43101594,28101594,19.85579,155,7.5,18
0,0,0,11.689337,94,5.5,28
15000000,21000000,6000000,3.043589,95,6.1,18
15000000,0,-15000000,17.141376,89,5.2,27
14000000,38574362,24574362,8.885017,97,4.4,27
0,0,0,4.115398,90,6.4,14
20000000,22165608,2165608,7.679336,92,5,28
15000000,20566327,5566327,18.268009,94,6,28
15000000,20529194,5529194,7.809701,117,5.9,18
15000000,17507368,2507368,9.378688,84,5.5,9648
15000000,35485608,20485608,35.395129,140,6.8,18
15000000,32556119,17556119,45.317278,108,6,80
15000000,0,-15000000,4.302941,109,5.3,18
15000000,42000000,27000000,47.006162,131,7.2,18
15000000,17080167,2080167,11.379652,114,5.9,14
15000000,37930465,22930465,24.612603,97,5.8,80
15000000,31554855,16554855,26.708193,121,6.5,53
0,0,0,8.710294,87,4.6,35
0,0,0,1.800119,85,5.9,12
15000000,22730842,7730842,0.335195,85,6.7,10402
25000000,15843608,-9156392,11.782725,87,4.4,28
0,0,0,2.711955,121,5.1,80
15000000,59389433,44389433,16.629173,107,7,18
15000000,16633035,1633035,20.05902,111,6.7,18
15000000,12000000,-3000000,8.113634,92,5.9,80
0,0,0,9.87419,97,6.4,28
0,0,0,2.857936,97,5.3,14
20000000,0,-20000000,3.138118,125,6.3,18
15000000,0,-15000000,6.684096,124,6.2,35
0,0,0,0.722911,76,2.9,10751
15000000,15608545,608545,17.672021,96,5.2,28
15000000,10443316,-4556684,3.033471,93,4.8,18
0,0,0,3.313257,96,5.4,10749
15000000,0,-15000000,41.089863,132,7.5,35
15000000,14867514,-132486,10.9071,103,6,10402
15000000,46189568,31189568,49.230089,117,7.8,35
15000000,10903846,-4096154,11.429607,116,6.6,18
15000000,9237470,-5762530,6.373316,118,6.5,28
16000000,18928871,2928871,9.717392,100,6.7,18
15000000,9902115,-5097885,8.074807,94,5,18
20000000,8586376,-11413624,7.034752,94,4.7,35
0,0,0,7.250379,97,6.7,35
0,0,0,0.116873,98,4.7,35
0,0,0,7.712206,91,5.5,18
15000000,34533783,19533783,25.329493,107,7.4,35
15,0,-15,5.112809,95,5.6,35
15000000,8762890,-6237110,13.832376,102,5.6,35
15000000,6405245,-8594755,7.446069,89,5,35
15000000,8138788,-6861212,13.568302,106,6,18
15000000,35097815,20097815,21.857387,92,6.8,35
15000000,5217498,-9782502,0.249245,105,4.7,53
15000000,12036149,-2963851,12.163832,121,7,12
0,0,0,8.962245,120,6,35
15000000,15785148,785148,32.690038,103,7.2,28
25000000,4152230,-20847770,8.583217,92,6.1,53
15000000,20117339,5117339,31.60985,147,7.6,53
0,0,0,12.295216,98,5.4,18
22000000,0,-22000000,12.4654,98,5.8,35
15000000,9455232,-5544768,30.983397,104,6.8,18
0,0,0,1.485324,276,7,18
15000000,5926410,-9073590,11.428903,111,6.5,53
15000000,0,-15000000,5.484679,98,4.8,12
0,0,0,5.770246,111,6.5,35
15000000,7938872,-7061128,15.175289,112,6.3,27
0,0,0,2.414721,100,5.5,18
0,0,0,0.470645,116,6.6,18
92620000,650422,-91969578,32.351527,153,8,18
12000000,9584131,-2415869,17.493735,84,6.5,28
8000000,529766,-7470234,6.932221,116,6.7,18
15000000,632542,-14367458,8.142166,105,6.6,28
15000000,0,-15000000,6.329672,98,6.5,18
0,0,0,7.744166,105,7.4,53
8500000,8936663,436663,9.029489,98,6,12
12000000,6814789,-5185211,22.708647,97,5.9,12
15000000,76382,-14923618,2.609057,93,5,18
15000000,3533227,-11466773,19.913961,98,6,9648
15000000,0,-15000000,1.897761,107,5.2,18
15000000,0,-15000000,7.701186,90,4.8,18
15000000,23000,-14977000,1.833058,99,6.1,28
15000000,20380,-14979620,12.185204,93,5.7,35
0,0,0,2.500218,141,5.6,18
20000000,27187375,7187375,6.459787,85,5.8,16
7000000,0,-7000000,49.808505,110,5.6,53
0,0,0,4.901936,105,4.8,28
15000000,0,-15000000,0.738646,,7.3,18
15000000,0,-15000000,5.294319,119,6.7,18
0,0,0,0.165367,124,4.5,18
14600000,70906973,56306973,52.744331,101,7.4,10749
14800000,122513057,107713057,29.660993,115,6.3,35
14500000,147298761,132798761,41.493042,120,6.7,18
10000000,17511906,7511906,10.072199,111,7.2,18
14500000,0,-14500000,4.389363,98,5.8,18
14000000,159157447,145157447,37.380435,131,7.7,37
14200000,674918,-13525082,7.05145,139,6.9,18
15000000,377910544,362910544,59.258969,120,7.6,18
14000000,320145693,306145693,16.742972,119,6.6,18
14000000,463000000,449000000,45.473484,119,7,10749
0,239606210,239606210,15.474831,110,5.5,12
0,0,0,4.289676,101,5,53
14000000,161001698,147001698,25.949277,145,6.7,18
14000000,154864401,140864401,22.409117,98,6.8,35
15000000,100734718,85734718,13.706357,101,5.3,9648
13000000,75511123,62511123,6.92205,114,6.1,18
14000000,185438673,171438673,27.17347,125,6.6,12
14000000,72527595,58527595,12.159009,99,5.6,27
0,0,0,4.448494,111,6.2,35
14000000,34793160,20793160,13.13724,107,6.5,28
0,0,0,4.04701,81,5.1,35
13000000,114956699,101956699,23.3784,105,6.2,36
0,0,0,1.446172,82,6.4,28
14000000,27515786,13515786,3.650857,109,6.9,18
14000000,25482931,11482931,5.102258,95,5.8,28
14000000,19800000,5800000,6.772615,100,4.5,35
14000000,30749142,16749142,11.543363,118,4.5,27
0,0,0,7.436315,83,5.3,27
14000000,0,-14000000,14.813614,83,4.4,35
14000000,22852638,8852638,20.792603,98,6.2,53
14000000,21409028,7409028,6.733485,103,5.7,35
0,0,0,7.708227,96,5.6,35
12000000,21001563,9001563,2.238646,117,5.8,35
0,0,0,7.866961,92,5.5,27
0,0,0,3.876242,155,6.1,18
0,0,0,1.89218,115,6.7,35
11000000,13196245,2196245,4.536745,90,5,35
11000000,16951798,5951798,11.220643,91,4.5,27
0,0,0,11.706309,120,6.4,36
14000000,10424470,-3575530,4.66723,86,5.3,35
14000000,11417362,-2582638,7.487843,87,5.5,35
14000000,19777647,5777647,13.65494,112,7.4,18
26000000,14821658,-11178342,11.942862,136,6.9,10749
14000000,5108820,-8891180,5.833687,90,5.5,18
14000000,0,-14000000,6.370267,107,6.2,18
0,4291965,4291965,4.052219,101,6.4,28
0,0,0,3.231848,84,4.4,27
14000000,2474000,-11526000,0.900442,139,5.2,18
0,0,0,8.387573,93,6.3,35
0,0,0,0.633004,127,5.8,28
0,5405500,5405500,9.242554,150,6.3,36
0,0,0,1.866443,104,5.8,18
0,0,0,5.930533,132,7.1,18
12000000,0,-12000000,4.930129,117,6.7,36
0,0,0,8.747922,113,6.3,35
14000000,46495,-13953505,4.898424,149,6.1,18
108,0,-108,7.410523,90,4,35
14000000,1755212,-12244788,24.210698,89,7.4,10749
14000000,178043761,164043761,44.135568,134,7.5,18
12000000,0,-12000000,16.051328,97,6.9,35
13500000,29027914,15527914,9.982885,107,6.9,18
14000000,12314651,-1685349,16.618874,93,5,35
13500000,7060876,-6439124,7.261196,124,6.8,18
15000000,19422261,4422261,32.306455,110,6.7,35
0,0,0,4.722403,105,6,18
18339750,92180910,73841160,32.445895,156,7.7,18
12806000,38535221,25729221,17.363739,125,7.2,18
13300000,5380251,-7919749,29.782161,108,6,53
13000000,123922370,110922370,18.362333,121,7.1,35
13400000,16700000,3300000,0.680753,100,4.7,28
13000000,98441954,85441954,6.735922,105,4.8,99
13000000,327803731,314803731,91.285683,108,7.3,18
13000000,47542841,34542841,105.792936,200,8.3,18
13000000,91038276,78038276,9.969624,112,6.3,18
7000000,72500000,65500000,17.113408,99,5.8,27
16000000,77000000,61000000,10.248439,117,6.7,18
13000000,73180723,60180723,25.316146,83,5.2,35
13000000,44726644,31726644,9.499325,107,6.6,80
13000000,54837234,41837234,43.791745,102,7.1,35
12500000,49002684,36502684,11.828068,100,6,35
16000000,53478166,37478166,54.550275,97,7.3,35
13000000,0,-13000000,13.525704,88,5.7,35
0,0,0,12.963328,84,5.7,35
17000000,119100758,102100758,60.829621,86,6.2,27
13000000,96060858,83060858,73.307513,113,7.3,878
0,0,0,7.964289,89,4.8,35
13000000,0,-13000000,2.388918,117,7.1,35
12000000,36450736,24450736,4.580081,97,3.3,878
13000000,27007143,14007143,6.425528,91,6.1,28
12000000,0,-12000000,4.63093,100,5.7,35
13000000,35763605,22763605,16.681567,84,5.8,18
13200000,53830415,40630415,24.656068,83,5.6,80
18000000,57096190,39096190,37.104353,126,6.7,878
15000000,36869414,21869414,95.130041,108,7.6,18
13000000,22863596,9863596,27.546914,112,7.3,14
6000000,0,-6000000,2.27213,90,6.6,35
13000000,45300000,32300000,17.371327,89,5.7,10751
13000000,16929123,3929123,6.130096,99,6.6,18
19000000,68673228,49673228,24.47248,141,7.2,28
13000000,11130889,-1869111,6.764437,104,6.2,12
13000000,8026971,-4973029,1.750054,84,5.5,35
6000000,35401758,29401758,66.11334,117,8.1,18
0,0,0,9.066881,82,6.5,35
13000000,7820688,-5179312,6.170139,95,6.4,35
13000000,27500000,14500000,4.742537,94,5.7,35
0,0,0,1.212956,99,6.6,18
13000000,16757163,3757163,11.880899,106,5.5,10402
0,0,0,10.131123,84,5.1,12
13000000,0,-13000000,5.831302,93,6.1,35
13000000,48065672,35065672,35.522027,93,5.7,35
13000000,4857367,-8142633,10.573191,120,6.8,18
0,0,0,4.898437,112,5.9,18
13000000,18000000,5000000,17.632446,107,5.4,35
0,0,0,1.780065,112,6.7,10749
15000000,8459458,-6540542,26.373864,96,5.9,18
13000000,9789900,-3210100,1.647335,91,4.8,35
13000000,2636637,-10363363,12.321302,125,6.5,18
13000000,33400000,20400000,43.444135,102,7.7,18
3000000,1200000,-1800000,1.279106,87,4.5,28
13000000,1151330,-11848670,3.680896,110,6.4,18
0,0,0,2.996284,120,5.6,18
13000000,1784763,-11215237,10.475368,91,4.6,53
14350531,3964682,-10385849,30.952377,88,6.3,28
10000000,303877,-9696123,4.267466,127,5.8,18
13000000,68572378,55572378,34.532418,94,6.6,80
0,0,0,6.116436,110,5.8,36
0,33082548,33082548,1.714972,90,5.3,10751
13000000,10652035,-2347965,19.664699,98,6.4,35
12000000,55260558,43260558,6.537986,100,7.1,12
12500000,23367586,10867586,13.349012,120,6.7,18
0,0,0,6.796079,108,6.9,18
12500000,12281551,-218449,35.268557,120,7.5,28
3100000,0,-3100000,7.453347,111,5.9,10749
12500000,10725228,-1774772,13.939054,100,7.5,80
13000000,0,-13000000,11.892615,109,6,80
0,0,0,5.69872,118,6,18
12500000,27206120,14706120,8.780512,101,5.4,27
0,0,0,4.021389,101,8.4,12
12000000,11293663,-706337,15.817096,106,7.1,35
12500000,20416563,7916563,34.821223,94,7.7,10752
12800000,40031879,27231879,22.022228,140,7.6,18
0,0,0,0.139384,132,6.2,18
12500000,1227324,-11272676,2.950618,99,7.3,80
15000000,5024782,-9975218,7.497306,90,5.8,35
20000000,31327899,11327899,26.396191,105,6.3,28
12500000,1083683,-11416317,6.546037,108,6,80
12300000,84460846,72160846,28.670193,69,7,16
0,15,15,9.572705,140,7.4,28
12500000,3878993,-8621007,0.903529,118,6.3,18
8000000,441306145,433306145,47.584643,122,7.5,18
7000000,470654000,463654000,50.152327,124,7.5,27
11000000,235483004,224483004,60.767168,95,6.4,35
12516654,8109160,-4407494,11.103202,78,7.6,16
25000000,79817939,54817939,15.26213,94,5.6,28
12000000,96070507,84070507,6.035152,122,6.9,35
12000000,75781642,63781642,10.297189,102,6.2,35
12000000,96800000,84800000,22.434102,113,7.3,28
15000000,107217396,92217396,41.249004,86,6.4,35
12000000,79567667,67567667,23.161754,114,7,53
12000000,68706993,56706993,19.195399,113,7,80
12000000,81272766,69272766,21.958055,110,6.3,28
12000000,114194847,102194847,45.477802,104,6.7,10402
12000000,0,-12000000,12.60629,81,6.5,16
12000000,39673162,27673162,40.631671,154,7.3,35
12000000,43493123,31493123,26.219598,107,6.2,35
15000000,145000000,130000000,64.504747,84,6.6,878
12000000,30400000,18400000,3.389249,132,6.2,10402
5000000,42365581,37365581,14.779537,116,6.6,10751
12000000,61141030,49141030,6.703319,93,4.7,28
12000000,100000000,88000000,49.070321,88,6.5,35
12000000,89800000,77800000,21.933822,172,7.3,18
12000000,52223306,40223306,20.624896,96,6.6,27
12000000,40855419,28855419,8.083995,89,5.5,27
12000000,56309766,44309766,11.135734,98,5.5,18
12000000,31179516,19179516,4.623609,97,4.7,35
12000000,31155435,19155435,11.510281,93,6.3,35
0,27281507,27281507,15.085981,85,7.2,35
12000000,56298474,44298474,18.422327,123,7.3,18
12000000,32726956,20726956,8.410688,93,6.5,99
12000000,307166834,295166834,74.358971,125,7.6,10749
12000000,22921898,10921898,18.422008,121,6.9,18
0,25434291,25434291,15.896312,102,6.3,18
12000000,54000000,42000000,8.61659,102,5.4,27
12000000,21133087,9133087,6.044161,99,6.5,27
12000000,100129872,88129872,29.019504,98,7.4,18
0,0,0,6.2464,118,6.4,35
0,0,0,5.315213,125,6.6,27
12000000,23006849,11006849,16.931846,104,5.8,14
12000000,85512300,73512300,64.610671,109,6.1,18
0,51,51,4.480167,86,4.3,35
12000000,17654912,5654912,29.223881,115,7.4,18
0,0,0,7.710797,92,6.7,27
12000000,17292381,5292381,1.081822,86,5.4,35
12000000,22939027,10939027,16.183746,94,5.6,35
12000000,42931041,30931041,47.992817,88,6.6,28
0,13960203,13960203,1.20245,93,5.3,35
12000000,12902790,902790,0.700792,100,5.3,35
0,21520719,21520719,10.409253,100,6.1,35
0,0,0,14.345428,113,6.1,18
12000000,0,-12000000,6.803763,122,6.4,10749
0,31466789,31466789,19.944479,101,6.4,18
14000000,85000000,71000000,26.967494,149,7.9,28
12000000,0,-12000000,3.444542,93,4.6,35
0,87100449,87100449,74.817641,123,7.8,35
0,92863945,92863945,21.064082,119,7.1,12
12000000,35485056,23485056,16.40512,100,6.1,18
12000000,32248241,20248241,32.940597,106,6.4,878
12000000,0,-12000000,13.427427,109,6.9,18
0,0,0,5.359381,81,4.9,28
8000000,6739141,-1260859,8.708229,95,5.7,28
12000000,5542025,-6457975,4.330428,86,5.9,35
0,0,0,7.594593,113,6,18
12000000,6754898,-5245102,4.770195,116,5.8,18
12000000,4922166,-7077834,1.623338,90,3,35
12000000,4939939,-7060061,2.993939,108,5.7,35
12000000,23,-11999977,10.536092,119,4.6,9648
12000000,3148182,-8851818,8.290636,110,6.6,18
0,0,0,3.603842,109,6,35
11000000,88489643,77489643,27.65527,119,6.7,27
0,0,0,1.379643,100,6.8,12
12000000,0,-12000000,9.164386,100,6.9,35
12000000,0,-12000000,9.779444,97,6.5,35
12400000,8371085,-4028915,32.523573,142,7.3,35
0,0,0,2.24888,104,6.4,35
12000000,12077441,77441,27.322212,99,6.5,18
12000000,19271312,7271312,12.664787,129,6.9,14
12000000,0,-12000000,3.004432,90,6.1,80
12000000,0,-12000000,4.795244,100,6.9,12
12000000,1644755,-10355245,5.841285,111,6.5,18
12000000,15250000,3250000,5.327714,114,6.8,80
1200000,0,-1200000,3.582733,86,6.2,35
0,0,0,2.678715,107,6.1,35
8000000,0,-8000000,9.728143,90,6.1,53
0,0,0,2.303865,103,5.3,18
12000000,0,-12000000,11.237374,120,6.8,18
0,0,0,1.906807,140,6.5,10752
12000000,0,-12000000,2.695896,110,5.2,35
0,0,0,1.416796,95,4.8,35
7500000,0,-7500000,11.636883,95,6.7,53
12000000,10652498,-1347502,4.793348,132,7.6,18
19000000,2570000,-16430000,0.738652,89,3,16
12000000,11212294,-787706,5.158067,131,6.3,878
20000000,17479,-19982521,5.727602,113,5.8,10752
12000000,0,-12000000,25.496926,99,6.9,27
1200000,0,-1200000,0.489271,111,4.3,18
12000000,101332962,89332962,11.150261,99,6,18
10000000,83557872,73557872,53.595686,103,7.7,53
0,0,0,0.186234,89,4.3,18
11500000,57469467,45969467,20.747994,103,6.4,18
0,0,0,2.930853,134,7.5,18
11500000,0,-11500000,4.75919,101,5.5,18
0,0,0,0.753362,130,6.3,18
11000000,153083102,142083102,45.072136,106,6.9,14
11000000,775398007,764398007,126.393695,121,8.1,12
11500000,94073028,82573028,56.805781,102,5.7,35
11000000,111858363,100858363,12.854853,197,7.4,18
0,0,0,14.637357,112,7.1,12
0,0,0,21.801188,116,6.2,35
25000000,93617009,68617009,31.019381,116,7.2,18
11000000,72778712,61778712,11.227087,95,6.4,28
11000000,64088552,53088552,19.231507,120,7.3,35
11000000,78874843,67874843,31.162838,106,7.3,18
12000000,0,-12000000,3.94487,96,3.9,28
11000000,49797148,38797148,7.559192,107,6.6,35
0,0,0,7.377587,101,5.6,35
13000000,97837138,84837138,38.018085,81,6.7,53
11000000,41227069,30227069,33.283554,101,7.5,18
11000000,39363635,28363635,15.864928,122,7.3,18
10500000,75902208,65402208,23.449703,97,6.6,18
11000000,68233629,57233629,31.900899,90,6,27
11000000,31672907,20672907,14.282314,92,6.5,35
11000000,38105395,27105395,7.645979,114,7.4,12
11000000,23978402,12978402,3.495758,86,4.1,28
12000000,37170057,25170057,7.558959,91,5.9,18
11,11,0,3.375208,145,6.4,18
12000000,4884663,-7115337,4.234269,100,5.5,878
11000000,62076141,51076141,39.337949,111,7.2,18
11000000,20000000,9000000,29.543331,184,7.7,18
24000000,14782676,-9217324,4.12064,89,5.8,35
24000000,13700000,-10300000,2.259537,84,5.7,35
11000000,59520298,48520298,7.722021,98,6.3,18
11000000,23430766,12430766,7.063053,95,4.9,35
11000000,13110448,2110448,16.003958,100,7,18
11000000,61619773,50619773,21.204929,120,7.3,18
0,0,0,6.799314,118,6.6,18
11000000,0,-11000000,33.758281,81,7.3,14
14000000,6413915,-7586085,9.371811,86,5.4,35
11000000,30000000,19000000,33.282794,118,7.5,10749
10000000,4069090,-5930910,3.208172,125,8.2,18
11000000,0,-11000000,4.131918,125,6.8,80
0,0,0,4.093288,91,5.1,35
11000000,2832826,-8167174,1.187671,113,6.6,35
11000000,32935319,21935319,36.319205,105,7.2,18
0,16017403,16017403,4.146752,95,5.8,18
11000000,2807854,-8192146,9.705589,98,5.1,18
11000000,2200000,-8800000,1.396985,124,5.9,18
0,2945242,2945242,4.056774,105,6,35
11000000,0,-11000000,5.062687,104,6.2,18
0,0,0,3.122152,111,5.6,18
10800000,113857533,103057533,32.943848,92,5.9,27
0,0,0,0.700127,116,7.3,18
11000000,0,-11000000,31.763201,97,5.9,18
0,0,0,8.950864,123,5.7,80
7400000,17000000,9600000,3.246903,193,6.1,18
14000000,18535191,4535191,4.519523,97,6.3,18
0,0,0,18.764453,98,5.2,878
0,0,0,6.340135,102,5.6,27
10500000,68700000,58200000,86.201184,149,7.9,878
10500000,792910554,782410554,56.105798,115,7.3,878
10000000,17500000,7500000,12.792446,97,5.8,10749
0,0,0,1.985552,97,6.8,12
10500000,123509,-10376491,0.037073,99,8.5,18
0,0,0,0.12082,135,5.2,18
11000000,0,-11000000,3.646848,110,5,18
12000000,9622846,-2377154,5.759545,145,6.4,36
11000000,0,-11000000,25.302978,105,7,35
10000000,225933435,215933435,43.734886,126,7.9,18
11000000,0,-11000000,10.016909,106,5.3,18
10000000,163876815,153876815,33.124871,108,6.1,27
10000000,85300000,75300000,10.892398,106,6.5,28
28000000,90449929,62449929,14.754281,98,5.8,35
10000000,118587880,108587880,53.727146,105,6.1,28
10000000,103166989,93166989,8.9876,95,5.7,35
10000000,139352633,129352633,29.244768,93,5.9,27
10000000,91196419,81196419,14.447723,101,5.6,18
6000000,57231524,51231524,5.882208,110,6,18
13800000,52293982,38493982,17.3393,119,6.7,18
10000000,50100000,40100000,19.524972,178,7.2,28
10000000,50752337,40752337,8.932837,101,6.4,35
10000000,183474602,173474602,35.695442,92,5.8,27
12000000,41205099,29205099,26.598884,92,6.5,35
10000000,59217789,49217789,23.316208,90,6.1,27
10000000,40485039,30485039,25.929893,90,6.7,12
10000000,37402877,27402877,8.305998,153,7,18
10000000,136836156,126836156,21.258991,124,6.9,18
10000000,44460850,34460850,5.699058,83,6.6,878
12305523,36230219,23924696,36.582038,107,5.9,28
10000000,57500000,47500000,34.224204,90,6.4,28
10000000,64188367,54188367,38.179483,97,5.8,27
10000000,33583175,23583175,30.934688,80,5.8,27
20000000,33526835,13526835,7.499639,85,6,35
10000000,104303851,94303851,45.946524,97,6.2,18
10000000,25754284,15754284,4.928777,108,6.4,28
10000000,32101000,22101000,10.125029,108,5.4,27
9000000,32973937,23973937,20.452449,89,6.4,35
10000000,30652890,20652890,14.543435,130,6.8,14
10000000,0,-10000000,6.015354,98,5.5,35
10000000,29450919,19450919,12.902975,101,6.2,18
15000000,30050028,15050028,6.216203,114,6.3,28
10000000,29392418,19392418,3.290639,100,6,28
8500000,34411240,25911240,4.844451,84,5,18
12000000,38368909,26368909,9.559737,103,5.3,35
10000000,25605015,15605015,11.350382,100,6.1,35
10000000,33697647,23697647,13.455373,91,6.9,80
65000000,143695338,78695338,31.974359,102,6.2,12
10000000,20766616,10766616,16.78512,103,6.9,27
10000000,52882018,42882018,26.090495,97,5.4,27
14000000,24637469,10637469,2.698185,116,5.8,18
0,0,0,5.904126,96,5,27
10000000,42333295,32333295,22.888173,98,5.8,9648
10000000,0,-10000000,5.025446,105,6.4,18
0,0,0,2.580808,123,5.2,18
0,0,0,4.192064,107,5.3,28
0,0,0,2.596338,112,6.1,35
9000000,17096053,8096053,18.289303,93,7.5,35
10000000,66821036,56821036,26.268209,100,4.7,878
10000000,85978266,75978266,17.592299,122,6.3,18
0,0,0,6.27141,101,6.4,35
0,0,0,11.158906,100,5.5,35
10000000,16153593,6153593,3.079862,129,6.3,18
0,0,0,8.288813,81,6.1,28
11000000,48572000,37572000,32.579697,96,6.6,28
12600000,28650575,16050575,33.555764,84,6,27
10000000,15795189,5795189,2.959547,99,6.6,37
25000000,15156200,-9843800,4.068107,110,6,28
10000000,21587700,11587700,17.663353,130,7,18
10000000,20342161,10342161,4.207456,84,5.6,28
10000000,0,-10000000,7.944457,92,8,99
10000000,0,-10000000,3.352702,90,5.4,35
0,0,0,5.856363,76,5.6,16
6400000,35057696,28657696,21.006078,99,6.6,18
10000000,17297244,7297244,5.647538,96,6.2,28
10000000,0,-10000000,1.000178,104,8.1,35
5000000,58978653,53978653,27.247013,108,6.7,53
0,0,0,1.83428,108,6.1,12
10000000,0,-10000000,11.592129,87,5.5,35
10000000,12827813,2827813,18.366362,89,7.4,35
10000000,10571408,571408,6.736274,98,6.4,35
10000000,28883511,18883511,28.570174,105,6.8,18
30000000,9898412,-20101588,5.671691,100,6.2,35
0,0,0,5.842299,89,5.3,35
10000000,8801940,-1198060,9.525626,114,6.4,80
10000000,6110000,-3890000,14.038512,90,5.1,28
0,0,0,9.177896,97,6.8,80
6000000,32438988,26438988,35.350303,90,4.4,35
10000000,0,-10000000,12.067921,95,5.3,35
10000000,9636289,-363711,30.863082,101,6.3,35
0,6861102,6861102,10.254807,87,5.9,35
20000000,23875127,3875127,73.567232,119,8.2,18
0,6842058,6842058,16.361743,94,5.9,27
10000000,0,-10000000,1.374409,74,5.5,16
18000000,9495408,-8504592,6.18869,131,7.3,18
10000000,0,-10000000,15.280261,112,7.7,18
0,0,0,0.753481,96,5.5,28
9500000,7800000,-1700000,14.105392,88,6.4,35
10000000,33000000,23000000,14.905357,100,6.2,35
10000000,2154696,-7845304,0.518056,79,3.8,35
9000000,21571189,12571189,12.172131,121,6.5,18
0,0,0,3.084874,85,4.1,35
10000000,7177143,-2822857,17.078656,126,6.9,12
10000000,10835752,835752,16.318608,107,6.6,35
10000000,4417580,-5582420,10.409155,83,6.1,18
0,0,0,5.355763,120,6.9,18
0,0,0,4.725357,112,5.4,18
11500000,3275585,-8224415,4.850402,100,5.7,28
10000000,3193102,-6806898,8.902102,89,6.6,28
6500000,98410061,91910061,28.223163,112,7.2,18
10000000,5164404,-4835596,3.007816,140,6.4,18
0,0,0,1.610132,92,6.8,28
0,0,0,8.326131,120,7.3,18
10000000,0,-10000000,3.919057,97,4.4,35
0,0,0,2.23411,135,6.3,35
10000000,40055439,30055439,19.865989,95,4.8,27
14000000,439564,-13560436,0.310513,118,6,12
10000000,7587485,-2412515,19.263477,97,5.8,35
10000000,1759252,-8240748,4.123533,98,7,18
0,0,0,6.948401,98,6.4,18
10000000,1631839,-8368161,3.988432,101,5.4,28
0,0,0,5.099923,132,6.8,12
20000000,1969193,-18030807,19.494703,105,6.4,53
0,0,0,3.759988,154,5.5,28
10000000,0,-10000000,4.176066,87,6.2,53
10000000,3665069,-6334931,16.436178,102,6.5,80
10000000,7022728,-2977272,14.979375,96,6.1,35
0,0,0,8.045488,104,6.8,80
0,0,0,8.312153,93,4.9,35
10000000,21786738,11786738,10.733761,111,6,18
0,0,0,0.111313,119,6.3,18
10000000,598645,-9401355,4.570043,89,4.8,35
5000000,1296184,-3703816,6.265659,106,5.6,28
0,42776760,42776760,17.54768,113,6.6,28
10000000,0,-10000000,3.412162,93,5.5,18
0,0,0,0.627964,105,6.4,35
0,0,0,5.75555,103,6.5,18
0,0,0,1.031142,100,5.3,18
7700000,1072602,-6627398,7.554799,123,5.9,18
10000000,0,-10000000,2.85283,111,6.3,35
0,0,0,1.769593,86,6.4,28
10000000,295750,-9704250,9.805551,99,6.5,35
0,0,0,12.898984,96,6.4,27
10000000,0,-10000000,2.803642,82,6,18
0,42145,42145,6.085879,110,6.4,18
0,126247,126247,11.946898,83,4.1,35
0,0,0,0.397341,0,6,18
10000000,0,-10000000,0.072085,125,5.8,10752
10000000,0,-10000000,2.849895,104,6.2,35
10000000,45779,-9954221,0.666218,86,3,35
0,0,0,1.388136,90,4.8,35
3200000,0,-3200000,2.631688,90,5.4,35
0,0,0,10.955567,90,4.7,35
0,140987,140987,0.122874,94,5.8,18
10000000,17472,-9982528,5.145655,111,5.1,18
10000000,9069,-9990931,1.728816,85,7,35
10000000,0,-10000000,3.064563,93,3.9,35
14100000,0,-14100000,9.318033,107,5.7,80
0,0,0,7.245108,94,5.4,18
0,0,0,9.085482,91,6.4,35
0,0,0,6.814247,99,5.6,53
10000000,0,-10000000,2.873796,91,4.3,10402
0,0,0,4.481897,117,6.1,28
0,0,0,1.413934,85,6.5,10751
10000000,0,-10000000,2.574014,106,6.4,18
10,11,1,1.617943,85,6.9,18
0,0,0,1.259968,99,4.3,35
10000000,0,-10000000,5.099472,90,4,28
0,0,0,2.131524,116,6.4,18
0,0,0,0.304566,85,5,35
10000000,0,-10000000,11.847324,130,7.1,28
10,10000000,9999990,10.013629,99,4.9,27
10000000,0,-10000000,3.753703,89,6.7,18
9500000,17164377,7664377,19.978021,107,6.4,35
9600000,4386236,-5213764,3.588529,144,6,18
11000000,59827328,48827328,9.337388,98,6.4,35
10000000,0,-10000000,11.431434,94,4.3,28
9500000,111584787,102084787,28.675891,117,6.5,28
10,0,-10,9.70276,102,6.1,18
8900000,19839492,10939492,17.151293,127,7.5,18
10500000,14144000,3644000,11.225044,98,4.5,27
9500000,0,-9500000,5.346205,87,4.9,27
9400000,60000000,50600000,14.562991,163,7,28
12899867,85582407,72682540,19.747809,121,7.3,35
9300000,0,-9300000,12.928269,90,6.2,16
10000000,0,-10000000,3.193777,89,6.2,28
0,0,0,5.107235,104,6.9,18
10000000,0,-10000000,10.073144,94,5.1,28
0,0,0,4.807549,131,6,18
7400000,21817298,14417298,36.173598,136,7,18
0,0,0,5.499412,92,7.1,18
0,0,0,5.900535,176,7.3,18
11000000,104931801,93931801,94.184658,117,7.9,27
85000,30859000,30774000,29.262427,83,7.2,27
10000000,2995811,-7004189,17.611971,106,6.3,18
9000000,83304330,74304330,7.623979,181,7.4,18
5500000,141195658,135695658,31.036,130,6.5,12
10000000,0,-10000000,10.424596,93,5.7,27
7000000,8220215,1220215,7.720692,110,7,35
9000000,41590886,32590886,6.717994,118,6.9,18
9000000,34573780,25573780,3.951041,120,6.8,18
9000000,44196684,35196684,27.600843,87,6.3,27
9000000,24538513,15538513,14.098952,123,7.3,99
9000000,108782847,99782847,82.975841,104,6.6,27
9000000,0,-9000000,3.269459,91,4.9,35
9000000,23936908,14936908,18.514292,88,6.6,35
9000000,0,-9000000,7.029126,126,6.7,18
26000000,28780255,2780255,11.233081,118,6.5,80
40600000,90400000,49800000,34.022209,116,7.1,35
9000000,21510851,12510851,4.134327,84,4.8,27
0,0,0,6.904734,85,5.8,35
9000000,0,-9000000,4.641006,137,7.4,10752
0,0,0,5.663889,114,6.8,18
0,6126237,6126237,1.118511,80,6.3,35
8500000,19125401,10625401,8.775844,119,6.4,28
9000000,4777465,-4222535,2.062087,97,6.5,35
9000000,4350774,-4649226,8.738737,79,6,35
0,0,0,4.976268,114,6.8,10749
9000000,0,-9000000,3.810697,91,5.7,28
9000000,2955039,-6044961,2.365328,97,6,18
9000000,0,-9000000,5.2545,103,5.5,35
0,0,0,5.293363,92,6.1,35
0,1053788,1053788,10.932711,119,6.9,18
0,0,0,9.05029,156,7.2,27
9000000,18663238,9663238,9.933926,84,6.8,99
0,0,0,0.843067,185,5.1,18
9000000,0,-9000000,8.218383,120,6,27
6000000,14348529,8348529,5.119593,98,5.8,35
9000000,0,-9000000,2.872281,128,7,35
9000000,771499,-8228501,0.717811,130,4.8,18
5000000,140666,-4859334,1.458884,86,6.1,18
6500000,0,-6500000,7.028946,130,6.8,80
9000000,1046166,-7953834,2.009597,97,4.5,35
0,0,0,7.247023,102,7,53
0,0,0,2.351706,105,5.6,18
9000000,0,-9000000,4.799022,103,5.8,18
5000000,328203506,323203506,16.072466,97,6.3,12
0,0,0,3.891186,76,5.2,16
8800000,0,-8800000,3.789485,90,5.9,53
7347125,0,-7347125,3.949796,122,7.3,18
0,20374201,20374201,14.038703,127,7.9,18
86000000,14373825,-71626175,18.172736,84,6.3,53
0,0,0,1.881466,69,8,28
9000000,0,-9000000,6.677926,96,5.6,53
8500000,32222567,23722567,24.750909,97,6.8,27
7000000,39462438,32462438,17.697042,112,6.8,18
9250000,29174648,19924648,7.000949,125,6.8,18
8500000,22456509,13956509,11.436405,96,5.6,35
9000000,2500000,-6500000,14.171759,98,5.7,878
0,0,0,0.702971,92,6.1,12
0,0,0,13.476596,99,6.7,35
12000000,20138836,8138836,3.604863,122,6.8,18
8500000,43528634,35028634,40.28709,100,6.8,10749
22000000,5271666,-16728334,3.809131,104,3.4,18
0,0,0,11.708343,101,5.6,27
8000000,0,-8000000,2.60632,135,6.6,28
8500000,4440055,-4059945,9.230073,119,6.8,18
12000000,42345360,30345360,14.719886,145,7.7,18
9000000,6108720,-2891280,28.540614,106,6.6,28
8000000,1997807,-6002193,0.034259,126,7,12
0,0,0,1.840511,128,6.6,18
6500000,22889018,16389018,6.787967,124,7.1,18
7700000,46000000,38300000,3.353176,159,7.2,10749
8250000,30000000,21750000,7.973109,171,7,18
0,188126,188126,5.897479,98,6.7,27
10000000,0,-10000000,1.465762,122,4.3,12
8000000,213928762,205928762,121.463076,154,8.3,53
0,76657000,76657000,10.639916,97,7,12
8500000,38697217,30197217,89.095538,117,7.6,80
8500000,5001655,-3498345,2.62082,104,5.1,35
8200000,286214286,278014286,37.960289,174,7.4,18
8000000,69821334,61821334,21.735068,111,6.1,35
8000000,100523181,92523181,14.793177,102,7.5,35
8000000,52287414,44287414,51.109279,89,7.8,80
5000000,82719885,77719885,45.490374,113,7.1,27
0,0,0,3.804597,95,4.8,18
8000000,43000000,35000000,26.356697,111,7.2,80
8000000,27362712,19362712,3.501158,109,7,35
0,0,0,2.088251,108,5.7,35
8000000,39187783,31187783,33.372828,100,7,35
0,0,0,8.864368,85,5.3,27
8000000,26049082,18049082,37.821106,94,6.1,35
0,0,0,4.293706,89,5.6,35
0,0,0,3.467923,80,7.5,12
8000000,0,-8000000,10.19377,111,7.2,18
6500000,81974493,75474493,25.289665,142,6.5,12
14000000,18090181,4090181,14.730796,112,6.4,27
8000000,22593409,14593409,4.482714,91,5.8,18
8000000,18948425,10948425,4.932893,112,6.7,18
8000000,17460020,9460020,7.894489,82,6.4,35
8000000,29010817,21010817,13.987772,97,5.2,35
7000000,34266564,27266564,45.310443,102,7.3,53
8000000,16856124,8856124,9.799177,93,6.1,18
8000000,12671300,4671300,5.069095,116,6.5,28
8000000,10629321,2629321,13.517017,118,5.9,28
0,0,0,1.353971,114,5.7,18
0,25288872,25288872,14.969093,93,6.6,35
8000000,74952305,66952305,45.395839,92,6.7,35
0,8880705,8880705,0.269661,110,3.9,35
8000000,8279017,279017,5.93923,92,6.6,18
8000000,10130000,2130000,11.837067,104,5.7,35
8000000,0,-8000000,2.149469,97,4.6,35
0,0,0,1.569449,89,4.9,35
8000000,0,-8000000,3.535789,92,5.5,35
0,25966555,25966555,5.897391,140,6.9,18
8000000,5659286,-2340714,21.024346,90,7,16
8000000,18124262,10124262,7.235794,129,7,35
8000000,0,-8000000,8.204829,111,6.9,35
8000000,2275557,-5724443,8.403859,79,5.7,28
0,0,0,4.221313,104,6.3,35
8000000,6491240,-1508760,13.143045,101,6.9,35
7200000,0,-7200000,6.138802,113,6.6,35
0,92,92,1.939054,92,6.9,18
8000000,589304,-7410696,8.717235,106,6.7,18
0,0,0,0.289433,98,4.3,18
0,0,0,10.621353,75,7.3,16
8000000,63464861,55464861,35.735689,104,7.3,35
8000000,852872,-7147128,7.433574,112,5.9,18
8000000,458232,-7541768,4.090382,99,5.8,18
0,0,0,0.812776,180,4.9,10770
0,0,0,6.335881,109,5.9,35
0,0,0,1.278092,111,7,18
8000000,426224,-7573776,5.244518,91,6.6,10749
0,0,0,1.265683,99,5.2,35
8000000,3453043,-4546957,10.791954,98,6.4,28
8000000,0,-8000000,9.782433,95,5.6,80
0,0,0,4.409263,142,6.9,18
8000000,143451,-7856549,3.942464,107,6.3,28
0,0,0,2.597665,105,5.6,35
8000000,53086,-7946914,6.500835,112,5.1,18
8000000,553171,-7446829,39.338097,124,7.8,878
22000000,413454,-21586546,12.893219,97,5.8,18
8000000,2019009,-5980991,0.983484,124,6.1,18
0,0,0,2.214925,96,4.6,28
0,0,0,1.86453,114,4.3,35
0,2455831,2455831,9.100352,93,7,18
8000000,0,-8000000,7.828459,104,7,18
7800000,22441323,14641323,11.000654,102,6.4,53
0,0,0,5.0005,90,5.4,28
0,882290,882290,6.41678,100,5.9,28
8000000,0,-8000000,2.101718,106,4.1,28
7500000,145793296,138293296,19.585801,99,7,35
0,0,0,4.105363,114,6.6,35
7500000,32392047,24892047,17.318839,91,6.5,80
7700000,0,-7700000,3.363973,110,6.6,18
6500000,24793509,18293509,29.01153,92,7.1,35
10200000,35619521,25419521,20.745052,93,5.6,27
7500000,26096852,18596852,16.990308,100,6.8,18
10284523,11588205,1303682,4.820166,104,5.7,35
7500000,0,-7500000,2.226412,109,5.8,35
6500000,12633747,6133747,8.526635,105,6.8,28
7500000,4245870,-3254130,1.369528,102,4.5,35
0,0,0,1.82184,97,4,28
7500000,3347647,-4152353,0.571663,110,6.1,18
8000000,10848783,2848783,14.652342,92,5.7,35
0,0,0,1.71729,112,5.2,18
0,0,0,0.024186,103,7,18
7500000,0,-7500000,8.859657,92,6.2,18
7500000,0,-7500000,0.086731,101,5.8,35
8000000,5634828,-2365172,7.802245,113,6.2,18
12500000,0,-12500000,1.589693,95,6.4,18
0,0,0,0.553752,156,6,10751
7300000,0,-7300000,24.281951,95,7.7,16
0,0,0,9.983004,92,5.6,53
7500000,19000000,11500000,25.281197,107,7.5,18
7000000,1333124,-5666876,38.150787,117,6.4,53
7300000,10329747,3029747,16.829837,103,6.7,53
0,2400000,2400000,1.288173,100,4.4,27
7500000,231411584,223911584,19.782725,96,7,35
7500000,0,-7500000,4.943588,104,5.5,28
7200000,116019547,108819547,34.634181,120,6.3,12
6000000,245066411,239066411,143.659698,175,8.4,18
4000000,92921203,88921203,18.422323,95,6.1,18
7500000,60722734,53222734,45.610993,95,7.2,35
7000000,116700000,109700000,17.681707,121,7.1,18
7000000,167221571,160221571,35.897151,110,6.1,18
0,0,0,11.199544,86,4.9,53
7000000,161777836,154777836,30.465138,121,6.4,12
7000000,0,-7000000,5.675535,95,6.5,35
0,55447968,55447968,29.173266,112,6.7,35
6600000,37710610,31110610,4.492455,112,6,35
7000000,54600000,47600000,17.717681,93,6.8,18
7000000,49084830,42084830,17.434862,114,6.8,80
7000000,25405445,18405445,25.511217,104,6.8,53
9000000,25000000,16000000,12.268143,119,6.6,12
7000000,97572000,90572000,30.214716,125,6.3,12
7000000,20256975,13256975,6.872784,96,4.9,28
0,0,0,23.413188,99,6.8,12
0,21268532,21268532,1.830306,46,7.5,99
7000000,36433975,29433975,14.741589,89,4.4,27
7000000,14702438,7702438,5.500324,92,6.3,35
0,0,0,16.754452,107,6.6,18
700000,17986781,17286781,29.761163,103,7.2,80
7000000,14011454,7011454,2.772178,97,6.2,18
7000000,16829545,9829545,19.301432,89,6,27
0,0,0,0.000372,90,4,27
7000000,31430334,24430334,23.612409,105,6.6,35
7500000,0,-7500000,6.557643,103,6.5,35
7000000,0,-7000000,9.887662,103,5.8,12
7000000,14618727,7618727,8.079046,116,7,10749
7000000,0,-7000000,21.626288,101,7.3,18
7000000,8373585,1373585,14.672151,164,7,18
7000000,7292175,292175,2.627232,96,5.6,10749
7000000,0,-7000000,12.150871,111,6.5,18
0,0,0,2.128211,94,6.8,12
0,0,0,2.881239,93,3.8,35
7,5,-2,4.857028,90,5.7,53
7000000,4720371,-2279629,2.206097,113,6.7,28
7000000,29385320,22385320,3.721858,192,7.4,18
7000000,0,-7000000,5.091253,99,6.4,18
7000000,0,-7000000,15.212569,91,6.1,35
0,0,0,0.838938,96,6.4,18
7000000,2062066,-4937934,7.051521,104,6.1,18
7000000,0,-7000000,11.400229,90,6.2,18
7000000,6038942,-961058,21.276864,112,7.4,18
0,0,0,1.799504,100,5.8,18
7000000,0,-7000000,2.932784,102,5,28
7000000,1246141,-5753859,2.550045,100,4.5,35
7000000,0,-7000000,5.517597,125,6.7,18
0,0,0,3.829937,107,6.2,28
0,0,0,8.893676,107,7.1,14
8000000,0,-8000000,9.590373,98,6,35
7000000,1429299,-5570701,7.155519,106,5.7,35
0,0,0,0.587276,95,2.7,35
7000000,382946,-6617054,13.635828,106,6.7,18
0,523511,523511,10.416332,93,5.8,35
3500000,0,-3500000,5.038953,103,6.2,9648
7000000,0,-7000000,1.498245,96,7.7,18
7000000,573335,-6426665,8.184588,103,7.1,10749
7000000,453079,-6546921,2.26778,108,5.9,35
7000000,1310673,-5689327,3.120016,170,6.7,18
7000000,46488,-6953512,8.207425,108,6,80
0,0,0,2.356244,120,6.3,18
6000000,30471,-5969529,34.917447,108,7.2,28
0,0,0,0.542814,92,5.8,80
7000000,0,-7000000,5.060656,84,5,27
7000000,12400000,5400000,5.33861,76,5.1,16
0,0,0,1.874783,53,6.5,10751
0,41410568,41410568,14.574995,115,7,10749
7000000,8900000,1900000,8.591387,97,6.9,12
6900000,7993039,1093039,26.181753,102,7.4,35
0,7000000,7000000,21.01755,104,6.1,35
0,0,0,3.139294,96,6.8,18
7000000,0,-7000000,6.665164,94,5.8,53
0,0,0,2.832628,125,6.3,18
0,0,0,3.528643,108,6.7,35
6800000,0,-6800000,4.665309,101,6.1,28
6900000,44287131,37387131,25.613197,101,5.6,27
6800000,7103838,303838,21.285206,130,7.9,18
0,0,0,4.240495,125,5.8,18
0,0,0,3.810943,88,5.1,28
4000000,0,-4000000,23.604936,115,7.8,18
6500000,255273813,248773813,60.225219,99,5.6,27
7,7,0,0.050456,82,5.2,35
6500000,57504069,51004069,17.705671,112,7.4,80
6500000,54215416,47715416,6.847099,108,6.8,18
0,0,0,8.067702,107,6.3,35
6500000,31899000,25399000,11.208769,105,6.8,27
6500000,0,-6500000,2.163683,108,6.2,28
6500000,28451622,21951622,11.142389,98,7,80
6500000,13368437,6868437,11.885221,88,5.1,35
6500000,12376563,5876563,12.524953,131,7,878
0,10,10,1.537859,91,4.1,27
0,0,0,3.481517,140,7,18
6500000,17693675,11193675,40.688426,100,7,18
6500000,11850214,5350214,24.0034,105,7,18
6500000,2025032,-4474968,2.639106,100,8,18
6500000,2401510,-4098490,16.574756,116,6.5,18
6500000,1548955,-4951045,5.483531,96,6.8,10749
0,0,0,1.068819,113,7,18
6500000,1521261,-4978739,8.432401,113,7.1,18
6500000,0,-6500000,2.074295,102,6,28
0,8159508,8159508,11.357474,121,7.5,18
6400000,78371200,71971200,74.234793,108,7.3,28
4800000,79384880,74584880,11.086001,121,7.4,35
10000000,0,-10000000,13.409125,97,7.2,18
4000000,14237000,10237000,14.961629,91,7.3,35
6000000,2122561,-3877439,16.139771,94,6.8,10749
6000000,181813770,175813770,67.608041,110,7.2,10749
6000000,138530565,132530565,49.802914,120,7.5,18
6000000,119114517,113114517,16.20985,122,6.8,99
6000000,102308889,96308889,24.499996,110,7.4,36
6000000,102272727,96272727,59.961523,139,7.4,35
6000000,0,-6000000,12.541983,124,7.4,18
6000000,43656822,37656822,23.431117,152,7,80
6000000,39846344,33846344,15.929648,98,6.6,35
0,0,0,3.029944,106,6.5,35
6000000,25059640,19059640,5.537646,106,7.1,35
6000000,23341568,17341568,64.025031,106,8.1,18
8000000,22168359,14168359,12.654051,89,5.5,27
5000000,38275483,33275483,35.108498,92,5.9,35
6000000,44703995,38703995,40.196514,109,7.3,18
6000000,20400000,14400000,7.60445,144,6.2,37
0,0,0,10.982255,90,6.7,35
6000000,50244700,44244700,24.351305,99,6.9,878
0,0,0,3.159574,121,6.2,35
6000000,18197398,12197398,12.601677,89,4.4,35
12716953,18814720,6097767,7.077505,113,6.3,80
6000000,18750246,12750246,4.053017,91,6.6,35
0,0,0,6.379933,104,5.9,35
6000000,58000000,52000000,15.639016,99,6.5,35
6000000,12000000,6000000,3.89204,98,5.4,80
6000000,48027970,42027970,26.286954,121,7.4,18
5000000,11642254,6642254,8.008844,96,5.2,27
5000000,9206470,4206470,12.68514,100,6.5,35
6000000,7518876,1518876,0.041651,42,8,99
0,0,0,8.483531,122,6.6,18
6000000,6852450,852450,3.561198,101,6.1,35
6000000,13231461,7231461,14.988746,96,6.4,18
0,0,0,5.754416,84,5.5,35
6000000,6670712,670712,6.497285,104,6.9,18
6000000,19560274,13560274,19.411141,96,6.8,28
7000000,6230276,-769724,7.034618,94,4.8,35
6000000,10409377,4409377,26.218912,97,7.1,18
0,0,0,4.647547,97,6.6,35
0,0,0,9.371534,89,5.4,35
5500000,5483299,-16701,15.015271,120,6.4,18
6000000,4398989,-1601011,5.696491,95,5.5,35
0,0,0,4.25422,95,7.4,35
6000000,3283371,-2716629,5.411243,99,6.9,28
0,0,0,1.273773,96,6.2,9648
6000000,2944752,-3055248,6.27257,94,6.6,18
6000000,2025238,-3974762,4.148253,95,6,35
0,0,0,1.369649,84,5.7,18
6244087,638641,-5605446,14.970654,145,7.6,12
6000000,2899975,-3100025,7.161051,99,6.2,18
6000000,0,-6000000,12.434688,110,6.6,53
0,0,0,2.507912,97,7.2,18
6000000,869325,-5130675,1.478505,107,4.6,28
6000000,399611,-5600389,0.215464,97,4.7,18
0,0,0,1.229667,104,5.7,18
6000000,0,-6000000,6.903186,99,6.2,18
134005,1332231,1198226,2.260315,104,5.3,18
6000000,0,-6000000,3.427061,97,5.9,18
0,0,0,0.669169,107,6.5,28
0,0,0,6.077735,117,6.3,18
6000000,69497,-5930503,2.404626,85,4.7,35
0,25,25,0.475748,152,8,99
6000000,0,-6000000,15.048067,86,6.8,80
0,0,0,1.734764,103,5.4,28
0,0,0,1.496454,87,5.4,80
12000000,66351,-11933649,10.19041,95,5.6,80
6000000,0,-6000000,12.099486,101,6.3,18
6000000,0,-6000000,4.957014,90,5.2,28
0,0,0,2.135689,240,7.6,10749
5952000,2120439,-3831561,18.119265,87,7.1,27
5300000,3897799,-1402201,13.034602,122,7,18
6000000,32251,-5967749,6.349218,86,5.5,18
4000000,530048,-3469952,5.013575,103,6.8,18
0,0,0,4.448353,90,4.9,35
5800000,6800000,1000000,4.49029,133,7.2,28
0,0,0,2.204138,91,5.5,18
6000000,27165581,21165581,11.81832,108,6.8,28
0,0,0,0.356495,99,10,35
3500159,76578641,73078482,22.054546,112,6.2,35
0,0,0,4.245123,141,6,18
5800000,7000000,1200000,3.201886,95,4.2,28
0,126,126,0.114342,139,4.7,28
5600000,18469680,12869680,22.341462,85,6.4,53
0,531826,531826,0.305922,105,3.9,35
5500000,159616327,154116327,28.500913,129,7.9,35
5500000,58972904,53472904,10.439971,123,6.8,18
0,0,0,3.784535,116,6.4,35
0,0,0,10.396305,105,7.3,18
6000000,0,-6000000,33.296684,90,5.9,10749
5500000,15700000,10200000,19.127239,105,7.4,37
7000000,0,-7000000,14.072941,111,7.1,35
0,0,0,2.714043,91,6.2,18
5500000,4865000,-635000,2.141143,95,3.3,35
0,0,0,20.982455,96,7.5,18
4361898,3031801,-1330097,2.080741,92,5.6,35
5000000,2466444,-2533556,7.79068,104,6.2,80
6500000,37295445,30795445,15.580335,120,7.6,18
0,0,0,5.336243,99,4.8,18
3850000,0,-3850000,10.787322,93,6.8,18
0,792,792,32.476098,97,7.1,18
5500000,0,-5500000,3.21392,100,5.4,35
2200000,11502151,9302151,5.206967,157,7.2,18
0,0,0,1.5846,90,6.2,18
8000000,0,-8000000,3.653305,96,5.6,35
0,0,0,3.865122,96,4.9,35
0,0,0,1.391958,90,7.3,18
0,15699707,15699707,20.821846,100,7.1,53
0,0,0,9.451228,94,6,878
0,0,0,1.688495,95,7.3,35
5500000,5000000,-500000,5.033065,120,5.9,18
5100000,0,-5100000,5.934016,103,7.2,878
0,0,0,0.075817,130,5.4,18
5000000,0,-5000000,48.375848,106,6.5,27
4000000,152925093,148925093,42.187986,92,6.3,27
15000000,108286421,93286421,53.698683,103,6.8,53
5000000,64282312,59282312,14.752587,87,6.1,99
4900000,44107032,39207032,48.170508,81,6.3,27
5000000,205703818,200703818,29.15813,83,5.9,27
5000000,103590271,98590271,56.30466,89,4.9,27
5000000,44793222,39793222,17.304055,96,6.5,27
5500000,99067206,93567206,9.59729,115,7.5,35
5000000,142817992,137817992,20.326337,95,5.2,27
4100000,36000000,31900000,4.028875,135,6.4,18
5000000,41833347,36833347,6.470766,113,6.7,35
11000000,34872033,23872033,16.856231,89,5.1,27
8000000,60378584,52378584,19.683187,110,7,80
5000000,28200000,23200000,9.358197,127,6.8,12
5000000,86362372,81362372,19.984477,84,5.2,27
5000000,26010864,21010864,30.271066,124,7.9,18
5000000,55198285,50198285,59.454473,117,7.9,18
3300000,64110728,60810728,20.304235,83,5.1,53
9000000,39723096,30723096,60.715151,113,8.1,9648
5000000,44030246,39030246,35.871248,104,6.3,27
5000000,26888376,21888376,18.077963,97,6.9,35
5000000,110000000,105000000,20.428237,110,7.4,18
4600000,23198652,18598652,32.14444,103,7.1,35
0,0,0,3.673566,94,4.7,35
3500000,20659423,17159423,3.656491,104,6.8,10751
0,0,0,1.88484,77,5.4,16
5000000,0,-5000000,4.227807,134,6.1,18
0,0,0,3.102862,129,6.5,18
10000000,17273593,7273593,15.688439,90,5.9,35
5000000,24804129,19804129,22.9951,134,7.1,28
0,0,0,5.769822,104,6.4,18
5000000,40100000,35100000,26.510558,93,6.1,27
0,0,0,7.544515,105,5.4,18
0,0,0,1.126941,109,6.1,18
5000000,43884652,38884652,35.307577,99,7.5,18
5000000,15000000,10000000,4.079111,139,6,36
5000000,19905359,14905359,7.058868,99,6.4,28
5000000,14000000,9000000,12.904615,100,4.8,27
5000000,368744044,363744044,18.115566,95,6.2,35
5000000,31724284,26724284,62.554173,94,5,18
5000000,15116634,10116634,9.483717,88,5,27
5000000,33616692,28616692,16.890285,106,7.3,18
4000000,30039392,26039392,49.12486,99,7.5,27
0,0,0,8.309894,82,4.3,18
5000000,13269963,8269963,5.960149,135,6.9,18
5000000,17768757,12768757,9.302349,88,5.9,27
5000000,0,-5000000,8.190888,89,5.8,27
0,0,0,5.87193,110,6.9,35
5000000,12232628,7232628,8.452666,107,5.5,28
5000000,25562924,20562924,17.028252,86,5,27
5000000,16174377,11174377,19.336367,102,6.5,35
5000000,54418872,49418872,38.006982,103,6.7,28
0,14056528,14056528,6.377523,118,6,28
5000000,12200000,7200000,0.835617,139,5.4,18
20000000,21164799,1164799,14.947588,92,4.3,10749
0,0,0,5.1299,99,6.3,18
4,25,21,1.199451,89,6.2,18
0,0,0,3.810827,96,5.2,35
5500000,0,-5500000,3.7387,82,6.2,14
0,0,0,9.85123,92,6.3,35
8000000,3432342,-4567658,3.03091,99,6.7,35
0,0,0,3.199904,106,6.6,28
5000000,0,-5000000,2.739307,90,4.9,28
5000000,7230000,2230000,5.348446,118,6.4,28
5000000,0,-5000000,4.070044,97,6.7,35
0,6538177,6538177,9.974681,94,6.6,35
5000000,0,-5000000,6.308298,91,6.5,35
5000000,5321508,321508,49.333137,175,8.1,37
5000000,5476060,476060,4.149628,94,6.3,28
5000000,9760104,4760104,46.114184,97,7.6,878
0,0,0,3.562563,90,5.2,35
5000000,4074023,-925977,4.498368,41,5.9,99
5000000,3263585,-1736415,7.673124,112,6.8,18
4000000,41424067,37424067,4.992475,120,6.5,18
5000000,4040588,-959412,6.174435,110,6.6,35
0,0,0,0.805312,87,4.6,35
5000000,3049135,-1950865,8.753409,99,7,18
5000000,4842699,-157301,3.943706,121,5.4,18
5000000,2614773,-2385227,9.169411,97,6,35
5000000,1980338,-3019662,2.732031,116,6,35
5000000,8203235,3203235,35.252056,101,7.3,53
5000000,0,-5000000,6.063868,103,5.7,18
5000000,2450846,-2549154,21.343093,112,6.6,53
5000000,5129058,129058,10.095184,91,6.9,18
5000000,742898,-4257102,4.129165,98,5.9,35
5000000,3220371,-1779629,30.001024,95,6.7,27
5000000,0,-5000000,6.759235,88,5.8,35
5000000,846704,-4153296,1.731035,99,3.9,18
7000000,560069,-6439931,11.700578,91,6.8,35
6000000,0,-6000000,2.388683,97,5.6,80
0,0,0,0.080704,136,6,18
0,0,0,0.888986,117,6.6,99
0,0,0,0.679351,94,6.5,18
5000000,5476793,476793,19.940245,89,7.3,35
0,0,0,1.286991,92,6.2,18
0,0,0,0.042442,128,6.6,28
0,0,0,1.116206,90,5.5,35
5000000,0,-5000000,3.05434,95,4.7,27
5000000,98450062,93450062,38.94708,94,6,27
5000000,782102,-4217898,3.792015,90,6.2,18
0,0,0,0.219799,95,3.8,10749
5000000,0,-5000000,7.794,91,4.2,27
5000000,0,-5000000,9.136965,107,7,53
0,0,0,8.39685,92,6.3,27
0,0,0,7.864905,87,5.8,18
0,0,0,1.963219,80,3.2,35
0,0,0,1.546169,95,7,18
5000000,0,-5000000,10.619574,105,7.4,10402
5000000,0,-5000000,0.999655,67,3,10751
0,0,0,1.985243,95,6.1,10749
0,0,0,0.102003,89,5,10770
15000000,0,-15000000,10.48009,94,4.5,53
0,0,0,1.136568,109,4.1,28
5000000,0,-5000000,11.095219,123,6.4,18
0,0,0,0.40703,0,0,35
0,0,0,0.028756,88,0,10751
5000000,0,-5000000,8.618793,88,4.7,35
0,0,0,2.394613,97,3.5,27
0,0,0,2.387463,120,7,35
5000000,17872796,12872796,5.461487,99,7.1,18
1000000,24475416,23475416,14.805264,135,7.4,18
4798235,209696,-4588539,25.30216,107,6.3,27
4800000,80578934,75778934,38.83192,94,5.7,27
0,0,0,3.500741,94,6.2,35
5000000,3099314,-1900686,19.807295,120,7.1,53
0,0,0,1.435742,112,6.3,27
0,0,0,7.667888,98,6.3,18
5000000,0,-5000000,8.496364,81,5.5,35
4700000,8025872,3325872,9.617777,101,5.9,27
4638783,11000000,6361217,4.495256,106,7.2,37
4800000,10337387,5537387,35.754865,90,5.6,18
0,0,0,0.20323,80,4.8,18
4,0,-4,0.28076,83,4.6,35
0,0,0,3.11319,105,7,18
0,0,0,0.137535,89,1,28
4600000,0,-4600000,6.368933,100,7.3,18
4700000,0,-4700000,0.217538,92,5.6,18
4600000,0,-4600000,3.531877,97,5.7,18
0,0,0,0.706355,103,5.9,18
4500000,146198896,141698896,15.002502,96,6.5,35
4500000,58853106,54353106,22.585384,104,5.8,10749
6000000,254700832,248700832,29.834065,117,6.6,35
4500000,27092880,22592880,20.403344,90,7,35
4500000,10400000,5900000,5.224593,116,6.9,12
15000000,13060843,-1939157,30.196039,135,7.2,80
4500000,7011317,2511317,15.359952,108,6.9,80
4500000,7390108,2890108,11.573034,102,7.9,80
0,0,0,1.847822,96,6.2,10402
0,0,0,0.425551,115,6.8,18
4500000,0,-4500000,3.819796,123,7,18
5000000,10429707,5429707,10.274542,98,5.5,35
6000000,1270522,-4729478,61.210016,113,7.7,14
0,0,0,0.177356,105,6.1,28
4500000,0,-4500000,0.011697,122,7.7,18
2000000,0,-2000000,6.249262,101,6.6,35
4500000,744816,-3755184,3.108881,97,6.3,35
0,23803308,23803308,17.074843,115,7.4,18
0,0,0,0.774442,120,6.2,18
0,0,0,8.816995,99,6,35
4500000,0,-4500000,8.48639,110,7,28
0,623528,623528,5.223096,98,6.6,12
0,0,0,7.759215,109,7.7,80
4500000,3606395,-893605,14.570359,104,5.4,18
0,0,0,0.371337,134,5.3,35
3000000,108981275,105981275,127.525581,133,8.2,18
4400000,0,-4400000,3.898737,85,6.9,35
0,0,0,7.315935,86,6.7,35
4500000,32000000,27500000,2.551559,126,7.3,53
0,0,0,8.772574,199,8.2,18
0,0,0,6.988357,103,5.5,12
3730500,6294161,2563661,6.938854,112,5.7,28
5000000,0,-5000000,11.21273,89,7,80
0,0,0,7.217328,124,6.5,18
8000000,41400000,33400000,12.439495,101,7.1,18
3250000,0,-3250000,2.126139,133,6.6,18
0,0,0,10.142218,120,5.9,53
4200000,0,-4200000,16.536374,98,6.1,35
0,0,0,0.933891,93,6.9,18
4200000,32000000,27800000,12.540624,114,6.3,14
3705538,62548947,58843409,8.839651,112,6.9,10749
4000000,125728258,121728258,12.891276,94,6.1,35
4000000,0,-4000000,10.789912,90,4.6,27
114000,30000000,29886000,25.666029,96,7.5,27
4000000,119723856,115723856,45.66662,102,7.3,18
4000000,38251425,34251425,35.892034,93,7.8,35
4000000,36000000,32000000,8.988455,152,6.6,28
4000000,44909486,40909486,14.042041,111,6.5,18
4000000,187112,-3812888,40.016306,95,5.2,27
3600000,49800000,46200000,22.030517,112,7.1,18
4500000,0,-4500000,2.503612,86,4.8,27
4000000,0,-4000000,4.117968,105,6.9,10749
4000000,52425855,48425855,24.161735,91,4.1,53
4000000,14400000,10400000,1.379354,105,6.4,18
3500000,34705850,31205850,15.338211,106,6.5,35
4000000,13008928,9008928,29.852608,94,7.1,28
4000000,11744471,7744471,35.061467,172,7.8,12
0,10000000,10000000,7.288352,109,5.8,99
5000000,15179302,10179302,10.605752,88,4.4,27
4000000,44349000,40349000,43.40352,164,7.5,18
4000000,31584901,27584901,17.229537,96,6.4,35
7000000,10229331,3229331,2.453459,93,5.3,28
6000000,9000000,3000000,1.433692,82,5.9,28
32000000,0,-32000000,9.976428,101,6.7,18
4000000,8200000,4200000,2.930058,124,6.8,18
0,0,0,7.173059,91,5.5,18
0,0,0,1.735462,82,4.8,35
0,44000000,44000000,29.071955,105,7.1,27
0,0,0,18.428909,87,5.4,35
4000000,0,-4000000,11.387335,110,6.3,35
4000000,6000000,2000000,5.975604,143,6.1,28
4000000,4630045,630045,4.59841,84,5.5,35
4000000,4300000,300000,22.87623,98,6.5,80
4000000,9304609,5304609,19.107285,104,6.7,35
0,0,0,0.456485,96,3.3,99
4000000,3468572,-531428,4.541908,110,6.7,18
0,0,0,4.348416,84,7.3,10402
0,0,0,3.347885,94,5.4,35
4000000,2426851,-1573149,6.091951,90,6.2,35
0,1919197,1919197,4.757625,96,6.1,35
4000000,1104682,-2895318,12.062371,88,5.9,27
4000000,866999,-3133001,7.758188,101,6.6,14
4000000,0,-4000000,12.781973,102,8,18
0,0,0,1.631993,87,5.1,14
0,1406224,1406224,12.690224,83,6.5,18
0,0,0,8.516229,103,5.5,53
0,0,0,5.90259,99,6.5,35
4000000,0,-4000000,2.866934,106,5.2,18
0,641100,641100,9.140936,115,6.9,18
4000000,2365467,-1634533,22.987897,118,6.5,18
3000000,302204,-2697796,1.204941,109,7,80
1300000,354704,-945296,7.605291,102,6.7,80
1500000,0,-1500000,2.855963,95,6,35
0,0,0,0.502396,87,5.8,35
4000000,0,-4000000,1.771584,119,8.1,18
9500000,120000,-9380000,21.230737,104,6.6,80
0,0,0,0.068246,103,6,35
0,0,0,0.541652,93,4.5,35
16000000,318982,-15681018,18.790221,100,6.1,18
4000000,0,-4000000,0.409089,100,4.2,18
4000000,146402,-3853598,3.663108,113,7.1,18
650000,33245,-616755,12.496261,98,6.2,18
0,0,0,0.596889,92,6.7,18
0,0,0,2.611364,106,6.4,18
4000000,355688,-3644312,3.238466,119,6.2,35
4000000,25345000,21345000,8.30723,99,6.2,12
0,0,0,3.408955,90,5.8,35
0,4037782,4037782,1.876621,120,7.3,18
0,0,0,1.807571,142,7.1,18
0,0,0,6.783053,93,5.2,53
3950000,8000000,4050000,8.484123,127,6.1,28
4000000,0,-4000000,0.936232,103,5.7,35
4000000,0,-4000000,12.822534,93,4.5,27
0,0,0,4.989985,84,6.6,27
4000000,0,-4000000,1.390659,78,4.1,27
4000000,0,-4000000,1.923514,0,5.2,35
0,0,0,4.118612,113,4.4,10749
3900000,28350000,24450000,9.541688,120,7.5,18
3800000,23689877,19889877,17.234745,121,7.7,18
4000000,400176459,396176459,48.98255,238,7.7,18
0,0,0,1.972668,98,6.5,18
3800000,14873,-3785127,3.490215,123,6.2,10752
3768785,8000000,4231215,1.726175,107,7.3,28
967686,4270000,3302314,20.544999,101,7,35
0,0,0,0.389471,115,6.7,18
3500000,44462,-3455538,8.45342,101,6.5,18
3700000,2956000,-744000,0.90522,102,6.6,10402
3800000,0,-3800000,2.201678,95,6,18
4000000,13401952,9401952,3.771652,109,6.6,35
3600000,44785053,41185053,21.119209,113,7.4,18
3500000,257850122,254350122,17.002623,91,6.8,35
3500000,83453539,79953539,46.116885,88,7.1,35
5000000,0,-5000000,1.398981,88,5.3,53
3500000,28215918,24715918,25.5748,91,7,35
3500000,27900000,24400000,3.418871,97,7.2,18
3500000,14000000,10500000,10.729884,92,5.9,27
3716946,5000000,1283054,2.676535,121,6.9,28
3500000,13007551,9507551,7.821438,134,7.4,80
3500000,12800000,9300000,3.281509,149,7.4,18
3500000,12000000,8500000,2.938973,121,6.2,28
3500000,12600000,9100000,10.219942,116,7.1,80
3500000,40423945,36923945,50.319662,92,6.3,9648
0,0,0,0.593068,93,5.4,28
3500000,9482579,5982579,8.406025,96,5.7,35
10000000,6451628,-3548372,5.588652,105,6.8,18
2000000,33965843,31965843,25.894065,129,7.8,80
0,0,0,3.280081,94,4.8,27
3600000,5923044,2323044,35.674774,84,7.6,27
0,0,0,3.115754,81,5.4,28
1000000,0,-1000000,20.466433,86,3.8,10770
0,0,0,0.015597,105,5.4,18
3500000,4159678,659678,12.982319,103,6.7,14
0,0,0,0.595136,104,5.8,35
3500000,113783,-3386217,3.643608,98,6.7,35
3500000,0,-3500000,6.396936,91,5.6,28
0,0,0,0.909067,111,2.9,80
3500000,0,-3500000,1.348114,98,5.2,80
0,0,0,0.964802,104,2,28
0,0,0,0.042346,200,0,18
3500000,0,-3500000,1.271621,96,4.6,27
3500000,0,-3500000,25.891466,78,7.9,28
3500000,0,-3500000,1.618138,100,0,99
3500000,0,-3500000,4.304341,85,3.3,28
3500000,0,-3500000,3.158056,92,5.3,28
0,0,0,3.230779,86,5,18
3440000,0,-3440000,1.913302,90,3.6,80
3400000,31063038,27663038,5.690619,94,6.5,35
8000000,127392239,119392239,17.537154,80,6.9,99
3500000,19504039,16004039,26.259389,107,6.7,53
0,0,0,1.419431,100,6.2,18
3000000,3830137,830137,11.637458,92,6,35
3300000,13092000,9792000,192.528841,105,8.3,18
3300000,30641770,27341770,44.356711,130,8.1,18
600000,4000000,3400000,4.859873,99,6.8,35
3400000,0,-3400000,6.723057,118,6.8,18
0,0,0,3.069605,85,6.4,9648
3800000,16800000,13000000,21.826888,115,7.9,18
0,19294144,19294144,15.128316,94,7.4,35
0,0,0,1.814802,91,6.7,18
4300000,0,-4300000,5.643023,98,6.2,28
3300000,45000,-3255000,2.964785,96,4.1,35
2000000,7,-1999993,0.11615,92,8,10749
0,28814580,28814580,13.437038,128,6.8,18
3200000,33395426,30195426,26.180367,136,7.5,27
3200000,8000000,4800000,11.735287,123,7.4,37
0,2277396,2277396,8.308442,99,6.9,18
0,0,0,3.027892,101,6.9,18
3200000,5332926,2132926,11.933449,105,6.8,18
0,658573,658573,8.825113,95,6.1,28
2700000,141000000,138300000,17.332585,109,7,35
2500000,124881062,122381062,47.812466,110,7.2,12
2400000,0,-2400000,11.753553,110,5.7,878
3180000,9644124,6464124,42.868495,130,8,18
4000000,16491080,12491080,63.513324,93,7.8,18
0,0,0,1.918959,115,6.3,35
3000000,177512032,174512032,22.789649,91,5.7,27
0,0,0,5.735912,91,7.4,35
4000000,35564473,31564473,11.414843,120,7.3,99
0,0,0,6.017273,111,6.9,18
3000000,29999213,26999213,21.607228,87,5.7,27
3000000,20966644,17966644,7.961559,117,6.9,18
3000000,89328627,86328627,54.403033,86,6,878
3000000,77712439,74712439,41.045084,110,6.7,27
3000000,19184015,16184015,0.295226,113,5,35
3000000,17570324,14570324,16.553594,108,7.6,18
3000000,18999718,15999718,24.393296,95,6.2,12
3000000,23144499,20144499,11.241802,98,5.3,35
16000000,68411275,52411275,9.18885,93,5.9,12
3000000,19472057,16472057,11.158167,86,5.7,27
3000000,33300000,30300000,23.109959,161,7.7,18
3000000,15369573,12369573,1.586598,100,4.7,35
2000000,7900000,5900000,3.832858,121,6.7,35
3000000,25000000,22000000,22.889294,125,8.1,35
3000000,15938065,12938065,10.341982,87,4.2,14
3000000,13000000,10000000,7.924982,128,6.4,9648
3000000,11718595,8718595,1.697846,100,6.4,35
0,229094,229094,14.936661,84,6.6,10749
3000000,0,-3000000,0.720091,97,7,18
0,0,0,2.747402,84,5.3,28
3000000,10400000,7400000,6.734965,146,7.3,18
3000000,10000000,7000000,13.338539,186,7.6,18
0,9016377,9016377,0.185373,94,4.5,35
3000000,9012000,6012000,5.344815,133,7.3,37
0,0,0,0.982624,99,3.7,35
3000000,11176469,8176469,23.299907,108,7.4,10749
0,0,0,4.103764,95,3.8,35
3000000,7282851,4282851,5.003615,97,6.3,28
3000000,6804016,3804016,0.019984,94,5,18
0,0,0,1.026243,86,5.8,35
0,10422387,10422387,2.787375,115,6.8,18
3800000,28200000,24400000,3.667372,97,6.5,35
3000000,0,-3000000,2.144354,82,3.1,35
3000000,4109095,1109095,3.937939,117,5.7,18
3000000,0,-3000000,5.325156,90,6,35
3000000,4000000,1000000,23.981601,100,7.4,10751
0,0,0,3.107149,98,5.2,14
0,0,0,5.016607,95,5.4,35
0,0,0,13.857194,94,7.6,18
0,0,0,6.997495,104,6.4,18
3000000,3076820,76820,4.337685,87,5.9,35
2962051,3011195,49144,3.636634,108,6.6,18
0,4069826,4069826,15.492257,86,7.2,35
3000000,9879971,6879971,2.504169,94,6.9,80
3000000,2807390,-192610,10.757539,139,7.4,35
0,0,0,1.580027,89,6.1,35
2800000,1826705,-973295,15.754614,102,5.1,35
3000000,14980005,11980005,56.76349,120,8,18
0,0,0,3.644872,110,6.5,28
3000000,748453,-2251547,16.900433,86,5.7,28
3000000,0,-3000000,1.569246,101,5.2,28
3000000,0,-3000000,4.682881,110,6.5,35
0,0,0,1.128559,87,5.8,10770
3000000,2357852,-642148,12.68672,123,6.9,18
0,0,0,3.750338,99,5.6,35
0,0,0,2.857848,176,4,27
3000000,11947954,8947954,20.95282,87,5.3,35
0,0,0,0.18094,120,3.7,18
0,0,0,1.75311,94,5.2,35
2700000,0,-2700000,3.120747,98,6.7,35
0,0,0,0.384496,0,6.3,10752
0,0,0,2.504156,96,3.9,27
3000000,0,-3000000,0.431332,97,5.8,18
3000000,22000,-2978000,11.882563,112,5.7,878
0,0,0,9.342465,88,6.1,18
3000000,3387000,387000,12.564554,83,4.9,53
0,0,0,0.68822,80,3,35
0,0,0,0.194848,90,0,35
0,0,0,2.015525,96,5.4,18
3000000,0,-3000000,2.680629,85,5.2,28
0,0,0,12.036888,84,5.3,35
0,0,0,1.737032,80,2.9,35
3000000,0,-3000000,9.249229,90,5.8,18
2500000,3200000,700000,5.164423,92,7.1,28
3,0,-3,0.008263,100,0,18
0,0,0,1.998826,88,4.8,53
3000000,0,-3000000,1.968679,95,4.6,9648
3000000,0,-3000000,1.141463,79,2.8,53
0,0,0,0.214704,88,6,
3200000,0,-3200000,1.034844,95,6.1,28
0,0,0,1.975941,95,6.3,35
2900000,5596708,2696708,5.928937,113,7.6,18
2900000,5000000,2100000,3.370225,136,7.3,35
0,0,0,5.485217,80,4.9,80
0,0,0,0.18887,105,6.8,35
3000000,0,-3000000,3.077885,90,4.1,53
3000000,103735,-2896265,1.781462,93,6.6,99
0,0,0,4.952983,91,6.6,27
2902660,0,-2902660,1.35088,93,6.1,10749
0,0,0,0.687656,89,4.3,53
8000000,23563727,15563727,6.39503,116,6.9,18
2883848,25000000,22116152,39.30982,122,8,35
2800000,19170001,16370001,9.070842,88,5.3,27
2777000,33754967,30977967,67.417542,102,7.4,12
2800000,86273333,83473333,36.444894,106,7.7,35
2000000,5364858,3364858,15.351412,95,5.4,27
0,0,0,2.436019,144,7.6,35
0,0,0,0.93392,112,6.5,18
2700000,37799643,35099643,11.35972,118,7,12
0,0,0,0.296981,0,9.5,
0,0,0,1.776624,90,4.9,28
2686000,6600000,3914000,1.897263,109,6,12
0,0,0,0.144031,103,7,35
2627000,5363000,2736000,0.531444,120,6,18
2600000,119500000,116900000,22.793929,93,7.2,37
2600000,32980880,30380880,14.013414,91,5.9,27
2159280,10700000,8540720,13.265432,80,7.1,18
0,0,0,11.552247,134,7.1,18
0,0,0,1.73892,86,5.3,35
2600000,3166000,566000,0.895946,105,7.6,99
2600000,553198,-2046802,19.02965,92,7,878
0,0,0,0.406645,99,7.4,28
2600000,0,-2600000,3.687574,97,5.2,27
2540800,7200000,4659200,36.556954,103,7.8,35
0,0,0,0.545825,97,7.1,99
2500000,60141683,57641683,18.661541,86,5.4,35
2500000,33400000,30900000,0.973582,87,4.6,99
0,34585416,34585416,14.885388,108,6.8,35
2500000,14400000,11900000,12.030456,98,5,27
2500000,12348905,9848905,18.30961,98,6.3,28
2500000,10000000,7500000,6.82919,112,7.5,28
0,32230907,32230907,9.799357,74,7.1,35
2500000,0,-2500000,10.363642,104,7.1,18
2500000,26781723,24281723,30.583959,102,7.1,35
2500000,5535405,3035405,23.672571,105,7.7,18
0,0,0,0.205034,100,6.9,27
0,0,0,5.581743,107,6.7,35
0,0,0,2.487255,91,6.8,35
0,0,0,0.262135,102,5.2,18
2500000,3325038,825038,23.419061,85,6.8,878
0,9726954,9726954,7.958831,106,7.2,18
2500000,6854611,4354611,25.722747,95,6.8,35
0,0,0,9.774126,101,7.2,35
0,0,0,0.197469,90,7,99
0,0,0,0.142255,100,7,18
2500000,71904,-2428096,0.301884,100,7.1,18
0,0,0,0.424957,80,5.5,99
14000000,0,-14000000,3.393648,106,6.1,35
0,0,0,5.025938,103,6.1,27
2500000,107559,-2392441,4.624691,90,6,18
2500000,324138,-2175862,12.204569,96,6.6,35
0,0,0,0.630226,89,5,35
2500000,0,-2500000,4.270489,87,4.9,35
35000000,0,-35000000,3.674294,94,4.8,27
2400000,5731103,3331103,4.623059,120,7,18
0,0,0,1.946715,101,4.8,18
30000000,495303,-29504697,27.940093,84,6.3,12
2500000,0,-2500000,1.759506,110,4.5,80
2380000,8176544,5796544,8.395624,101,7.4,18
2500000,0,-2500000,8.248149,101,3.1,28
2361000,6892000,4531000,0.628051,101,7,35
2450000,0,-2450000,0.500753,105,4.6,18
0,565592,565592,0.376662,97,10,35
2300000,11000000,8700000,1.606314,107,6.9,10402
0,0,0,0.197264,91,4.7,18
0,0,0,5.759493,108,5.6,53
2000000,0,-2000000,6.86302,90,6.7,14
2280000,83320000,81040000,32.875469,124,7.2,16
0,0,0,0.015295,90,0,53
4000000,36690067,32690067,14.206525,95,5.7,27
2200000,21930418,19730418,12.639469,92,5.1,27
0,0,0,2.371477,117,6.2,18
0,0,0,2.470443,115,6.6,14
0,0,0,1.532518,90,5.7,53
2160000,9132000,6972000,0.1813,119,5.8,18
2300000,0,-2300000,2.713171,97,5.6,53
0,0,0,0.258413,90,3.5,35
0,0,0,2.025701,90,5.4,10749
0,0,0,2.659804,85,5.7,28
2100000,23650000,21550000,8.38717,172,7.6,18
0,480811,480811,6.677093,113,6.7,80
0,0,0,2.526356,89,7,35
2100000,3330,-2096670,0.039007,126,0,18
1500000,30448000,28948000,31.691617,78,7.1,27
0,0,0,0.47909,88,4.5,18
0,0,0,0.027801,0,0,
0,0,0,2.122451,77,5.1,53
0,0,0,0.803761,81,4.1,12
2000000,78898765,76898765,41.298723,115,6.9,28
0,0,0,1.791331,96,5.3,35
2000000,18344729,16344729,10.664202,89,7,35
2000000,14674076,12674076,100.876794,100,6.6,27
2000000,18016290,16016290,13.223111,88,6.6,35
2000000,13129846,11129846,22.139842,129,8,80
2000000,24600832,22600832,37.117362,95,7.3,12
0,0,0,15.046612,102,7.2,28
2000000,11540607,9540607,15.557144,118,7.2,80
2000000,13101672,11101672,11.66632,85,5.2,27
2000000,70000000,68000000,34.938177,137,7.9,18
1000000,34522221,33522221,5.961119,129,6.8,18
2000000,7600000,5600000,17.639478,134,7.6,18
2000000,9172000,7172000,1.867004,119,6.5,12
8000000,1477676,-6522324,13.944645,80,7.3,12
0,0,0,2.304552,89,6.6,18
0,6003587,6003587,7.792851,101,7.1,35
2700000,15992615,13292615,14.799323,80,7.6,18
2000000,20908467,18908467,23.281616,154,7.6,18
2000000,4601043,2601043,20.331593,100,6.7,80
2000000,7800000,5800000,5.381536,118,6.8,18
2000000,13831503,11831503,20.834883,100,6.8,18
0,13885802,13885802,14.045887,106,7.6,99
2000000,4000000,2000000,0.483974,106,4.8,18
0,0,0,9.719094,90,7,35
2000000,7871522,5871522,16.930914,109,7.7,99
6000000,11122090,5122090,28.819424,96,6.3,18
0,0,0,18.223139,116,7.2,80
2000000,5967038,3967038,12.999023,120,6.3,80
2000000,2801508,801508,6.728882,97,5.6,80
2000000,2506446,506446,1.95686,96,4.8,35
0,0,0,7.151154,98,5.9,27
2000000,5179037,3179037,14.846001,101,6.3,10749
2000000,11125849,9125849,14.08251,90,7.8,18
2000000,1672730,-327270,0.031947,120,5,
2000000,1431623,-568377,2.283796,102,7.2,99
2000000,1477002,-522998,18.224326,98,6.8,18
2000000,0,-2000000,3.43159,109,7.6,99
0,876302,876302,4.749885,104,6.5,18
2000000,653621,-1346379,3.980072,92,6.8,36
0,0,0,1.096355,99,7.1,18
0,0,0,1.196943,96,5.6,35
2000000,563706,-1436294,3.125382,120,4.6,35
2000000,390659,-1609341,5.261065,104,6.3,28
0,0,0,6.337735,97,6.1,35
0,0,0,7.359286,94,5.2,35
2000000,124494,-1875506,1.892183,91,5.8,28
0,0,0,0.001186,0,0,
2000000,120620,-1879380,3.911445,90,7.1,18
3800000,111731,-3688269,2.559806,84,5.9,35
0,0,0,0.744406,96,6.3,35
13500000,187674,-13312326,5.16023,129,5.2,18
7000000,1100000,-5900000,0.253595,93,6.7,16
0,0,0,0.046868,100,5,18
0,0,0,2.952932,97,5.6,12
0,0,0,5.563068,94,5.5,35
0,0,0,1.161034,95,6.4,35
2000000,54207,-1945793,7.502934,97,5.9,35
0,0,0,5.350423,92,6.1,18
2000000,622806,-1377194,4.261509,96,6.3,18
0,0,0,6.752141,87,6,27
0,3983997,3983997,20.362373,91,6.7,27
0,0,0,5.099368,98,5.4,53
0,0,0,6.632891,86,5.3,27
0,0,0,1.717376,120,6.8,18
0,0,0,4.922397,99,6.9,53
1000000,0,-1000000,13.222268,92,6.1,53
100000,95000,-5000,7.447714,86,5.5,27
2000000,0,-2000000,9.68793,98,5.2,80
2,0,-2,0.050625,,0,99
2000000,11833696,9833696,5.941852,82,6.7,35
0,0,0,0.174311,103,3.5,53
0,0,0,0.361554,76,5.8,28
2300000,0,-2300000,8.055084,87,7.2,80
2000000,0,-2000000,4.346271,88,4.4,27
14000000,0,-14000000,3.419685,97,5.6,28
2000000,0,-2000000,5.100741,96,5.7,35
0,0,0,2.253589,87,6.7,35
0,0,0,0.209475,106,6.6,35
0,0,0,3.613577,107,5.3,35
0,0,0,1.296784,85,6.3,9648
7000000,0,-7000000,4.50829,88,5.2,35
0,0,0,8.902102,99,6.1,35
0,0,0,1.619635,102,5.9,99
0,0,0,1.002585,108,3.9,28
0,0,0,1.332804,90,4.2,878
2000000,0,-2000000,2.00163,89,4.4,53
2000000,0,-2000000,1.187764,92,4.4,53
19000000,0,-19000000,6.463806,99,6.7,80
0,0,0,1.980265,103,6.7,14
1950000,0,-1950000,3.696123,90,5.8,53
1987650,19152480,17164830,32.841229,94,6.6,18
0,864659,864659,8.518866,97,7.4,18
0,0,0,4.892203,88,7.8,99
0,0,0,4.665026,95,5.8,18
0,222000,222000,1.294967,160,5.6,18
0,2957978,2957978,14.331992,94,7.5,53
0,0,0,3.068463,82,5.8,18
1900000,0,-1900000,1.367751,89,6.9,18
1800000,67738090,65938090,14.838986,87,5.6,27
0,0,0,1.950959,98,7.2,18
1800000,8000000,6200000,14.884756,125,7.6,18
1800000,9440272,7640272,41.996783,95,8,18
1800000,0,-1800000,2.179428,118,6.2,18
1800000,21107746,19307746,12.471239,93,6.8,18
1700000,8844595,7144595,13.315383,93,5.5,28
0,0,0,3.363321,109,5.6,18
2000000,841733,-1158267,1.699101,109,5.3,18
0,0,0,0.320387,155,6.7,35
0,621951,621951,0.692497,87,6.4,35
0,0,0,0.023436,93,5.5,35
0,0,0,0.749699,108,6.8,12
1800000,6800000,5000000,11.756943,114,6.7,37
0,0,0,0.225627,87,6.9,80
0,0,0,6.833164,113,5.3,27
0,0,0,0.060127,87,0,53
1800000,0,-1800000,1.959405,86,4.2,28
1800000,0,-1800000,0.21544,101,5,35
1530000,7267585,5737585,27.36562,81,7.2,28
500000,150277,-349723,8.650779,93,6.3,18
1493619,0,-1493619,2.492747,90,4.9,12
0,23311391,23311391,2.756435,106,7,18
1700000,9700000,8000000,18.828683,88,6.1,28
1700000,0,-1700000,6.979638,130,6.4,18
2000000,572809,-1427191,26.281839,108,6.3,53
1700000,1943649,243649,2.079125,98,5.5,35
0,0,0,3.939753,86,6,18
1000000,4235151,3235151,14.017809,104,7.3,18
0,0,0,3.677831,100,5.9,18
1644736,7433101,5788365,3.426314,126,7.2,35
1650000,30500000,28850000,6.915201,118,7.2,10752
1600000,5400000,3800000,8.535178,103,7.1,37
0,0,0,2.160586,102,6,18
0,6033999,6033999,0.796009,84,6.3,35
0,2592808,2592808,0.13456,0,4.3,18
0,0,0,4.554574,96,6.8,18
0,0,0,3.215465,92,4.6,53
0,0,0,1.49436,114,7.6,18
1600000,4420000,2820000,20.810292,113,7.5,80
0,0,0,0.122704,0,0,10749
0,0,0,3.654018,123,6.7,80
0,0,0,3.313339,111,6.5,18
0,0,0,5.379319,99,4.4,27
2000000,22179430,20179430,9.67299,108,6.7,35
1500000,11806119,10306119,17.49699,92,6.6,28
1500000,9600000,8100000,12.2624,129,7.9,35
1500000,7412216,5912216,13.291991,91,6.8,18
1500000,11098131,9598131,13.788054,81,6.9,35
1000000,10013424,9013424,3.990215,97,5.9,35
17000000,0,-17000000,6.526588,90,4.5,28
1500000,7000000,5500000,11.145915,111,7.3,18
0,0,0,5.446832,103,6.5,18
1500000,2375097,875097,10.009994,110,7.1,10749
1500000,97009150,95509150,58.594852,103,6.8,27
1500000,2300000,800000,11.35344,92,6.7,35
1500000,0,-1500000,8.589355,114,7.4,80
0,0,0,2.828303,101,6.5,99
1500000,712294,-787706,3.618646,111,6.5,18
1500000,3566225,2066225,15.017068,104,5.5,35
1500000,418961,-1081039,5.817519,96,6.1,28
1500000,416925,-1083075,9.856826,98,6.8,18
0,414404,414404,4.262374,106,6.5,18
0,0,0,0.06124,93,3,53
1500000,373967,-1126033,11.064228,100,6.2,27
0,0,0,1.742383,80,5.7,35
0,330048,330048,0.414754,95,4.5,18
0,0,0,12.677016,83,5.7,35
1,8500000,8499999,28.27648,87,8.1,18
0,0,0,0.87066,91,6.4,18
1500000,173066,-1326934,7.5591,86,5.9,35
1500000,0,-1500000,2.02817,0,3.5,35
1500000,0,-1500000,0.859014,97,6.6,35
1500000,0,-1500000,0.071377,108,6,18
1200000,0,-1200000,0.193172,128,6,18
1500000,32000,-1468000,4.680206,93,6.6,27
2000000,0,-2000000,1.20173,90,6.8,18
1,0,-1,0.094105,90,10,10749
1500000,1165882,-334118,14.504326,101,5.1,27
0,0,0,10.322858,109,6.5,27
0,0,0,1.404175,98,6.9,99
1,0,-1,0.077876,87,6.8,35
0,0,0,0.35819,98,6,18
9000000,0,-9000000,9.159265,112,6.4,35
0,1500000,1500000,1.893697,85,2.6,878
0,0,0,0.71087,102,7.4,35
0,0,0,1.105357,102,4.2,53
1500000,0,-1500000,2.815228,90,3.3,18
0,0,0,0.446858,93,7.5,28
1488423,184925486,183437063,80.171283,83,6.9,14
1400000,0,-1400000,0.684881,106,6.8,18
1455000,2620000,1165000,3.598457,113,5.4,37
1,0,-1,1.452152,94,5.9,12
2000000,0,-2000000,1.193219,101,5.3,18
3150000,0,-3150000,8.039223,100,5.2,27
0,0,0,2.486992,75,6.2,18
0,0,0,0.43049,91,0,53
1377800,0,-1377800,9.815394,105,6.1,10751
1350000,3897569,2547569,16.032594,105,7.5,35
0,0,0,0.592821,104,0,37
1300000,0,-1300000,10.240917,105,7.7,18
0,0,0,3.443916,95,6.7,35
1300000,639000,-661000,0.072066,135,5,18
0,619042,619042,0.430758,105,6.5,18
0,1632,1632,0.143784,79,6.1,27
0,0,0,0.077873,135,0,18
0,0,0,0.319792,88,2.8,878
1000000,0,-1000000,1.600797,85,5.9,28
0,0,0,0.285131,122,2.3,35
0,0,0,5.628399,82,3.2,35
0,0,0,5.065752,103,5,18
1288000,6000000,4712000,18.426825,130,7.7,18
1250000,21722776,20472776,16.517777,87,6,27
1250000,11000000,9750000,6.903314,101,7.4,18
1250000,3412497,2162497,4.45544,88,5.3,27
0,0,0,0.106949,100,5.9,18
15000000,0,-15000000,0.165909,87,5.8,12
1250000,8500000,7250000,9.903992,92,6.7,80
1250000,6000000,4750000,7.70019,118,6.8,18
0,0,0,4.480579,123,4.1,53
1200000,0,-1200000,10.869492,100,6.7,18
1200000,103911669,102711669,63.655973,103,7.2,27
3000000,18492362,15492362,16.312803,100,6.6,35
1,0,-1,0.025364,99,0,
1300000,0,-1300000,1.473405,87,5.7,35
0,0,0,8.109958,114,6.8,35
0,0,0,7.142448,111,6.8,18
1200000,7000000,5800000,6.920873,99,6.9,35
0,0,0,4.826908,85,6.5,35
1200000,2861020,1661020,3.085411,114,6.3,18
1200000,14661007,13461007,66.925866,99,8,80
0,0,0,1.280733,88,6.4,18
1200000,6000000,4800000,88.377076,161,8.1,37
0,0,0,9.683622,110,7.8,18
1250000,0,-1250000,1.6116,106,5.8,18
0,0,0,0.002386,88,0,35
900000,25000,-875000,0.097913,97,6.8,99
1200000,0,-1200000,0.047781,85,0,35
1344000,0,-1344000,20.422246,103,4.1,18
0,0,0,0.021678,98,0,18
0,0,0,1.998557,88,6,80
0,0,0,8.148187,88,3.9,35
1200000,2736000,1536000,2.968235,115,6.8,28
0,0,0,1.36514,0,4.4,53
1200000,0,-1200000,0.057564,84,4.8,
2600000,2850263,250263,8.001156,91,6.1,28
1200000,0,-1200000,1.079125,97,6.7,28
0,0,0,1.906151,91,4.2,27
0,0,0,0.100533,0,2,27
3000000,18637690,15637690,10.230583,94,6.2,35
0,0,0,12.818441,90,7.2,18
1100000,1400000,300000,1.220072,99,6.8,35
0,0,0,0.014406,0,5,99
1596010,0,-1596010,0.552361,75,6.9,27
0,0,0,0.147886,97,6,18
1100000,0,-1100000,7.717237,110,5.7,14
1100000,4105187,3005187,40.285095,101,7.3,28
0,0,0,0.249457,90,3.1,27
0,0,0,0.447166,0,4.4,27
878000,10462500,9584500,43.729123,102,7.9,18
0,0,0,4.653047,84,6.1,27
1250000,0,-1250000,3.000435,156,7,18
1000000,0,-1000000,11.095414,89,6.3,12
1000000,117235147,116235147,72.19808,119,7.5,18
0,0,0,0.926084,92,4.1,18
1000000,37600000,36600000,2.833166,128,6.1,12
1000000,62882090,61882090,41.972329,82,5.5,27
1300000,28262574,26962574,58.845025,114,8,80
1000000,17985893,16985893,6.532855,91,6.4,18
950000,59600000,58650000,48.901542,110,6.9,12
0,18112929,18112929,20.649145,88,4.9,27
1000000,14564027,13564027,22.583834,94,6.9,27
5000000,23507567,18507567,6.96858,121,5.7,18
1000000,10047674,9047674,6.926926,90,5.6,27
1000000,10037390,9037390,3.322721,107,5.9,12
3500000,16566240,13066240,26.881611,112,6.9,18
1000000,13350369,12350369,9.773398,103,6.9,18
1000000,101758490,100758490,13.152822,83,4.6,53
2090000,40000000,37910000,4.289003,109,6.6,35
1000000,9000000,8000000,1.444258,89,5.5,18
1000000,46243000,45243000,14.139004,100,6.7,99
1000000,7800000,6800000,3.851,100,6.2,28
0,0,0,2.162522,122,7.2,99
5000000,6833445,1833445,17.845161,100,5,28
0,0,0,0.42583,109,7.5,18
1000000,9138338,8138338,9.115486,98,6.6,18
0,0,0,15.017162,94,7.4,99
0,5355847,5355847,1.86221,107,6.8,18
0,0,0,1.334481,96,6,35
0,5284309,5284309,15.699363,90,6.7,18
0,3538446,3538446,17.806082,101,6.7,18
0,3123963,3123963,10.12895,83,6.7,35
0,0,0,4.805651,97,6.7,18
1000000,0,-1000000,5.247956,89,7.4,99
1000000,2057193,1057193,4.86805,84,5.4,18
0,0,0,0.367312,86,6.6,35
1000000,1678874,678874,5.323184,92,7.2,99
1000000,1744858,744858,3.424158,94,6.3,35
1000000,0,-1000000,9.954848,92,6.7,35
1,0,-1,0.29245,100,6.7,18
1000000,852206,-147794,0.280083,119,7.3,80
1000000,623791,-376209,0.043023,170,6.1,18
1000000,0,-1000000,5.06516,94,6.2,35
0,0,0,3.65924,108,5.9,18
0,0,0,0.948316,97,7.7,35
1000000,464000,-536000,0.672695,92,6.7,18
0,0,0,16.570708,100,6.4,18
0,0,0,0.51799,120,6.8,80
0,0,0,8.542921,88,6.7,35
0,336472,336472,37.555398,106,7.5,878
1000000,0,-1000000,5.20209,79,5.6,35
1000000,444575,-555425,8.887411,115,7.5,99
1000000,274661,-725339,0.748565,106,6.6,99
1000000,0,-1000000,0.436148,97,4.7,99
0,0,0,0.030253,120,2.8,18
0,0,0,0.690089,90,4,
1000000,0,-1000000,1.883947,92,7.2,18
650000,0,-650000,1.631274,93,6.4,99
1000000,0,-1000000,0.341461,114,4.7,18
0,0,0,0.887821,200,3.4,53
0,0,0,8.628485,95,6,9648
0,14870,14870,6.507094,93,6.2,35
0,0,0,1.190729,88,6.3,35
1000000,0,-1000000,0.340019,104,5.2,10749
0,0,0,0.678475,98,6,35
0,0,0,9.055447,82,5.5,28
0,0,0,0.108468,118,4.4,35
1000000,10018,-989982,2.175696,78,6.2,80
1000000,0,-1000000,1.50211,97,5.4,18
1000000,7202,-992798,1.260314,81,6.6,18
0,0,0,0.547654,96,0,
0,0,0,0.0206,97,4.8,28
0,0,0,0.429587,88,3.3,18
0,0,0,0.098351,96,8,35
1000000,0,-1000000,3.629777,105,6.2,80
0,0,0,0.060003,0,8,10751
900000,0,-900000,7.145832,76,6.4,18
1000000,0,-1000000,3.638411,96,4.9,18
0,0,0,1.255771,99,5.4,28
0,0,0,0.783842,84,3.5,35
0,0,0,0.118324,94,6.1,18
0,0,0,0.023681,87,5.5,18
0,0,0,2.948576,93,6.1,18
0,0,0,0.243853,90,4.5,
0,0,0,1.563711,92,4.7,27
1000000,0,-1000000,0.653495,85,4.8,27
0,0,0,1.233688,96,7.6,10749
1000000,0,-1000000,0.153625,90,5.7,35
0,0,0,0.328498,85,5,35
1000000,0,-1000000,0.4594,84,3.2,37
0,0,0,7.207051,83,4.9,53
0,0,0,6.679954,95,5.7,27
0,0,0,1.284741,94,5.3,18
1000000,0,-1000000,0.973323,90,6.6,878
1,0,-1,1.859965,95,4,27
0,0,0,3.418372,93,3.5,35
0,0,0,0.65434,90,4.1,18
950000,814666,-135334,0.178689,103,6.6,18
950000,0,-950000,7.310879,87,5.7,27
950000,0,-950000,8.976128,100,5.5,18
0,0,0,0.280829,90,5,35
913000,0,-913000,0.795698,83,7.4,99
910000,9600000,8690000,16.015599,108,8,80
930000,30905,-899095,5.974156,100,5.3,35
852510,1185783,333273,9.270133,113,7.3,18
0,0,0,0.392658,0,5,27
950000,7022209,6072209,25.918007,103,6.8,18
900000,381420,-518580,4.0971,96,6.1,18
0,0,0,2.34239,107,7.4,18
0,17385830,17385830,20.967146,85,7.3,18
0,0,0,10.639774,100,5.8,35
858000,267447150,266589150,47.651878,70,6.8,16
0,0,0,0.957022,88,6.5,35
850000,819939,-30061,5.424916,107,6.7,18
0,0,0,0.007254,78,0,18
1000000,0,-1000000,0.175885,90,5,18
850000,1243961,393961,14.238376,85,5.8,35
0,3094813,3094813,9.436431,91,6.4,35
0,0,0,0.339757,95,5.2,35
0,0,0,3.060685,85,6.5,80
0,0,0,5.023091,86,5,28
0,0,0,0.504251,90,2,53
800000,0,-800000,12.049373,123,7.7,18
0,0,0,0.108135,93,7,35
0,0,0,5.870319,88,6.9,35
800000,1001437,201437,0.59424,114,5.6,18
800000,2816116,2016116,3.643662,88,7.8,18
0,0,0,1.824184,109,7.6,18
0,0,0,0.006943,0,0,
0,0,0,0.038706,83,7.8,18
0,0,0,2.171288,101,6.1,28
800000,62852,-737148,5.292536,94,7.3,18
0,0,0,0.004922,87,0,18
0,0,0,1.186971,90,3.7,35
800000,1984662,1184662,11.205726,91,6.1,27
780000,0,-780000,6.003418,90,6.6,28
0,0,0,0.322553,14,5.9,27
777000,140000000,139223000,19.326115,110,6.9,35
0,0,0,1.517771,75,8,99
0,0,0,1.453146,86,6.5,16
750000,4007792,3257792,25.186002,85,6.8,35
0,0,0,5.498834,89,7.7,35
500000,171760,-328240,12.203041,95,6,27
750000,78396,-671604,14.386807,102,5.4,27
750000,0,-750000,8.429295,107,7.6,18
500000,0,-500000,0.471264,88,5.6,18
0,0,0,3.283886,99,4.5,27
750000,0,-750000,12.284939,90,5.7,27
0,0,0,1.039149,95,3.8,27
730000,8000000,7270000,18.644023,85,7.6,37
700000,7830611,7130611,9.188431,171,7.7,99
0,0,0,1.623769,86,5.9,99
700000,1667192,967192,7.731064,97,6.7,18
0,0,0,2.868942,104,6.5,9648
0,0,0,0.631571,84,5.5,80
700000,4911725,4211725,12.378031,107,6.5,18
700000,10508,-689492,0.578798,107,0,18
0,0,0,0.003142,92,0,28
750000,0,-750000,1.471139,80,5.2,53
650,0,-650,1.352222,90,4.8,27
0,0,0,0.429083,103,6.2,99
0,0,0,0.045648,70,0,99
0,0,0,4.596157,90,5.6,9648
625000,0,-625000,0.283059,68,4.8,18
700000,0,-700000,2.659006,87,5.3,18
609000,3202000,2593000,3.898498,101,7.4,35
60000,248000000,247940000,41.690578,81,6.3,27
600000,34505110,33905110,3.409764,225,7.1,36
600000,0,-600000,10.861167,83,6.4,35
0,0,0,0.099902,106,5.5,28
0,0,0,0.006069,103,0,53
0,0,0,0.069277,90,6,18
0,0,0,0.350557,0,3,80
522360,0,-522360,0.071349,105,5,10402
0,0,0,0.012942,0,0,
0,0,0,2.651304,102,6,18
0,0,0,1.501688,98,4.8,53
560000,12299668,11739668,10.730056,88,7.3,35
56000,0,-56000,0.010909,80,0,99
550000,0,-550000,0.001586,98,4.6,18
0,0,0,0.061248,83,6,35
500000,33456317,32956317,6.093989,122,7,18
550000,0,-550000,0.48088,115,4.2,99
0,0,0,2.651418,86,6.1,12
130000,54667954,54537954,15.611857,79,5.4,18
0,0,0,1.292948,87,5.8,35
500000,17000000,16500000,2.537032,97,5.7,27
0,0,0,0.772668,105,7.2,99
500000,8679814,8179814,11.578545,88,7.4,18
0,0,0,0.05021,120,6.2,18
0,0,0,0.906096,94,7.3,99
2053648,500000,-1553648,2.778633,102,7.8,99
0,0,0,0.920591,102,7.5,35
46000,0,-46000,1.447734,83,6.3,18
500000,845188,345188,0.109579,93,7,99
0,0,0,1.09454,86,5.6,18
0,0,0,0.082978,101,4.8,35
0,0,0,0.619136,111,7,18
500000,603943,103943,8.519202,90,6.9,80
0,0,0,0.36447,86,4.8,10749
0,0,0,0.039077,98,4,35
0,0,0,0.665512,95,5.3,80
0,0,0,3.433625,91,6.4,35
0,343341,343341,17.378455,90,6,10749
500000,0,-500000,0.425195,88,7.1,99
2000000,271841,-1728159,39.756748,207,8.2,28
0,0,0,0.388401,89,6.9,99
500000,0,-500000,1.354816,97,4.7,35
0,0,0,0.459625,84,4.9,35
500000,98017,-401983,9.108949,85,5.7,35
0,0,0,1.65426,100,4.2,18
0,0,0,1.390909,112,6.2,18
500000,4242978,3742978,26.406001,94,6.2,18
0,0,0,0.218736,91,4,18
0,0,0,0.383442,91,5,35
500000,0,-500000,2.391847,87,4.5,35
0,0,0,1.68502,98,6.9,28
0,0,0,0.607782,95,7,99
500000,0,-500000,0.046903,87,5,18
0,316472,316472,10.924273,104,5.9,28
0,0,0,0.021419,96,0,
0,0,0,14.142073,103,7.3,18
500000,0,-500000,1.600171,104,3.5,27
0,0,0,0,0,0,
0,0,0,0.397323,110,3.4,28
0,0,0,3.637857,90,6.5,9648
500,0,-500,0.080105,101,0,80
0,0,0,0.251828,94,5.2,10749
0,0,0,0.674398,0,6,10402
0,0,0,0.072359,90,0,53
0,0,0,0.087574,108,5.5,10751
0,0,0,0.069244,82,5,99
500000,0,-500000,0.073079,84,2,
0,0,0,6.672008,82,6.3,878
0,0,0,0.161517,0,4.3,18
0,773228,773228,7.330691,107,7.2,28
0,0,0,0.165257,0,2.4,
450000,973525,523525,4.442355,84,6.2,18
0,0,0,3.905877,103,5.9,27
0,0,0,0.136721,0,0,
439000,2281000,1842000,1.933366,89,6.1,10402
0,0,0,0.052942,0,8,
225000,0,-225000,1.014966,98,7,35
0,0,0,4.321249,132,6.9,10749
0,0,0,0.160234,90,4.2,27
400000,46118097,45718097,23.603514,95,6.7,35
0,258384,258384,25.349758,90,6.9,80
15000,193355800,193340800,47.456823,86,5.9,27
0,0,0,3.291609,91,7.2,99
400000,5028948,4628948,64.782984,91,7.8,12
0,0,0,0.034135,90,7,18
0,0,0,0.033883,0,1,
218,1162014,1161796,1.063439,91,7.5,99
0,0,0,0.084344,92,3.8,99
0,0,0,0.133619,0,5,27
0,0,0,8.022122,87,6.6,27
35000000,170000000,135000000,38.100488,99,5.8,35
500000,0,-500000,1.428483,80,5.5,27
860000,2451545,1591545,3.703005,97,6.6,10749
0,0,0,0.003352,84,0,18
0,0,0,0.231297,97,5.6,18
0,0,0,11.347855,91,7.8,18
385907,8394751,8008844,3.232447,197,7.4,18
0,0,0,2.77754,86,6.3,99
379000,4358000,3979000,0.968865,100,5,18
350000,29400000,29050000,35.037625,85,7.3,27
6000000,31081,-5968919,19.331884,89,6,27
0,0,0,0.59458,84,5.1,36
300000,1750211,1450211,1.085909,88,6.9,99
0,0,0,5.061107,90,4.9,28
0,0,0,0.049921,90,6.8,99
350000,0,-350000,0.249561,98,4.7,878
350000,1000000,650000,59.259204,96,8.2,18
0,246574,246574,1.170257,83,7.6,16
325000,4500000,4175000,11.871424,105,7.7,35
0,110197,110197,28.858238,94,6.9,18
300000,7808524,7508524,1.314576,112,8,10402
312000,1281176,969176,1.505703,102,6.2,35
8,16,8,11.818333,98,6.4,14
0,0,0,1.410387,91,6.1,35
300000,0,-300000,4.270596,81,6.4,35
0,0,0,0.627763,0,0,
300000,0,-300000,1.673208,73,6.3,18
200000,0,-200000,0.713906,80,6.4,18
0,0,0,0.17817,88,4.8,18
300000,0,-300000,7.791898,110,7.6,18
0,0,0,0.025211,104,7.3,99
300000,2074000,1774000,0.055868,101,5.5,99
0,0,0,0.008453,95,7,18
300000,40542,-259458,0.374291,94,3,18
0,0,0,0.045429,0,5.3,28
0,0,0,1.088501,90,2.8,28
0,0,0,0.062979,110,7,
300000,8000000,7700000,6.473667,80,5.9,28
0,0,0,1.905197,90,6.8,27
0,0,0,0.001389,94,0,27
300000,0,-300000,0.006323,98,0,10749
0,0,0,0.583446,99,6.2,18
0,0,0,1.452199,96,5,27
300000,0,-300000,2.733725,97,5.7,35
0,319285,319285,8.942203,90,6.3,18
250000,12021272,11771272,20.601483,113,6.7,35
250000,4186931,3936931,1.45917,91,6.3,35
0,0,0,0.005883,0,0,
0,0,0,3.877036,101,6.5,80
0,0,0,1.70819,94,5.7,35
0,0,0,0.812855,96,5.7,35
250000,0,-250000,0.126304,100,5,18
300000,0,-300000,0.018087,90,0,18
250000,501818,251818,44.656151,90,6.9,53
0,0,0,0.619348,78,5.8,35
250,203,-47,0.293649,72,7.5,18
0,0,0,5.742359,73,4.9,18
250000,3542353,3292353,21.825564,90,6.4,18
0,0,0,0.055325,96,3,27
0,0,0,0.375423,92,5.5,35
0,0,0,0.120505,75,7,18
250000,56825,-193175,6.978907,99,4.1,53
0,0,0,0.493223,86,5.9,18
0,0,0,5.251143,92,6.9,18
0,0,0,20.265518,101,6.6,53
250000,0,-250000,0.130169,90,4.8,878
0,0,0,0.46049,93,5.5,10402
0,0,0,0.399491,94,0,18
250000,0,-250000,5.217002,106,6.4,28
250000,0,-250000,0.065103,96,5.7,18
0,0,0,1.063615,107,5,80
0,0,0,0.010607,0,0,
0,0,0,1.084387,0,4.2,27
0,0,0,0.172299,108,5.5,10751
0,0,0,0.278981,90,0,99
245000,22000000,21755000,0.785744,151,7,18
0,0,0,0.0921,0,10,35
250,0,-250,0.166655,118,7.7,10749
230000,2260712,2030712,18.450613,92,6.9,18
0,0,0,0.58954,106,0,37
225000,111300,-113700,0.126676,86,6.9,10769
0,0,0,0.065155,103,5.2,10749
100000,27000000,26900000,1.183892,69,4.3,35
210000,5000000,4790000,2.043661,80,6.7,12
400000,100000000,99600000,33.142185,93,6.6,12
200000,4505922,4305922,13.971674,94,6.8,35
200000,14500000,14300000,38.771062,99,7.6,37
200000,2200000,2000000,0.622752,66,5.1,35
0,0,0,0.004998,85,0,
200000,2295733,2095733,0.616283,101,6.5,18
0,0,0,2.836537,101,6.6,18
0,2611555,2611555,5.937602,119,6.3,10749
200000,0,-200000,0.06104,103,8,10402
0,0,0,0.062089,86,8,99
450000,0,-450000,1.077321,90,4.9,80
0,0,0,0.472123,92,5.5,
13000000,0,-13000000,4.009379,95,4.6,27
0,0,0,3.299345,84,5.8,18
0,0,0,0.018716,89,0,27
0,0,0,0.092562,59,7.7,99
0,0,0,3.225189,126,7.8,18
0,0,0,1.948435,86,6.1,35
0,0,0,31.339015,87,7.7,878
0,0,0,0.15066,106,6.8,99
0,0,0,4.980585,86,4.6,18
0,0,0,0.145014,89,6,18
0,0,0,0.036532,105,0,10402
0,0,0,1.045623,93,6.5,53
0,0,0,0.254659,94,0,18
180000,900000,720000,7.072118,89,7.8,18
8000,469947,461947,1.041254,96,7.4,18
0,0,0,6.722213,84,6.1,35
0,0,0,0.015189,77,0,99
0,0,0,0.327622,104,0,18
100000,1776935,1676935,25.402697,92,6.8,18
150000,15200000,15050000,0.132878,97,4.6,28
200,0,-200,0.050978,109,5,18
150000,2891288,2741288,8.570328,78,5.5,35
160000,20710513,20550513,19.052179,85,7.3,18
0,0,0,0.619979,90,4.9,18
0,0,0,0.465404,93,5.5,99
0,0,0,2.805351,86,5.8,53
0,0,0,0.076647,98,0,28
0,0,0,8.701183,25,7.5,16
0,0,0,0.021392,72,0,99
0,0,0,2.557258,73,7.2,99
0,0,0,0.523122,80,6.8,99
160000,6706368,6546368,3.284903,91,7.4,99
0,0,0,0.015697,89,0,
0,0,0,6.192383,85,6.3,878
0,0,0,0.005256,90,0,
125000,3200000,3075000,12.833247,90,6.5,18
120000,0,-120000,2.213889,88,5.9,35
120000,0,-120000,1.112792,95,7.1,18
8500000,15861566,7361566,9.452808,120,6.5,18
0,0,0,0.002388,70,0,35
100000,10178331,10078331,4.563698,111,6.6,18
100000,42664410,42564410,18.045782,87,4.9,27
10000,7000000,6990000,20.399578,89,7.5,18
0,0,0,2.353483,78,5.7,35
0,0,0,5.497682,100,7.1,35
0,0,0,0.001117,99,4.9,28
0,0,0,1.680525,90,6.5,35
0,0,0,0.28397,0,0,10751
0,0,0,10.826253,85,6.3,18
0,0,0,7.676677,96,7.4,99
0,0,0,8.302951,88,5.2,53
0,0,0,0.186401,68,7,80
0,0,0,0.053755,85,5,53
0,0,0,0.074005,106,7.3,80
100,0,-100,0.394575,77,5.5,99
0,0,0,0.020168,80,6.4,99
60000,3221152,3161152,27.788067,84,7.1,9648
0,0,0,0.020839,86,6,35
0,0,0,0.408073,87,3.7,10749
75000,0,-75000,0.140989,90,3.3,878
65000,28575078,28510078,10.400603,100,6.6,99
0,0,0,0.838957,82,4.5,35
0,0,0,7.052422,82,5.2,35
62000,0,-62000,2.407048,82,4.4,27
0,0,0,0.176377,75,6.4,18
0,0,0,0.620554,87,6.7,18
70000,0,-70000,6.328665,92,5.8,9648
0,0,0,1.578903,98,6.3,35
0,0,0,0.833937,83,6,18
0,0,0,0.557602,99,6,18
65000,416498,351498,2.380332,99,5.6,10749
60000,0,-60000,0.412342,93,5.1,53
0,0,0,0.077577,110,5,18
50000,0,-50000,0.293587,111,8.3,99
50000,0,-50000,1.777148,47,6.9,27
0,0,0,0.048726,93,5,99
4000000,600896,-3399104,27.662696,95,5.8,53
50000,0,-50000,0.54562,81,5.7,99
0,0,0,0.76368,83,6.6,18
0,0,0,0.970351,96,6.8,35
0,0,0,2.058834,89,6.4,18
0,0,0,0.00734,90,7,35
0,0,0,0.049469,95,2,53
0,0,0,0.160779,83,3.2,27
0,321952,321952,3.277287,117,7.9,99
50000,0,-50000,0.595809,75,3.5,53
0,0,0,0.611081,80,6.4,18
0,0,0,0.003582,78,0,28
500000,0,-500000,0.123068,109,6.1,18
0,0,0,0.056459,89,0,27
31192,10000,-21192,1.330379,89,6.3,18
27000,3151130,3124130,19.748658,92,7.4,35
27000,0,-27000,0.027811,64,6,18
0,76901,76901,0.362633,85,6.3,18
0,0,0,2.634007,97,6.8,35
0,0,0,0.039264,78,5.5,18
0,0,0,7.101197,85,6,28
0,0,0,3.320622,97,6.4,35
0,0,0,0.038143,90,0,53
22000,0,-22000,0.048948,90,6,35
0,0,0,1.048524,120,6.8,18
0,0,0,3.619167,91,4.7,53
0,0,0,1.243955,85,6.2,18
0,0,0,0.327794,60,0,18
0,0,0,0.67457,88,5.6,35
0,0,0,3.545991,78,4.2,878
12000,6000000,5988000,4.553644,93,6.2,27
0,0,0,1.464566,111,6.7,18
0,0,0,1.193779,90,6.6,18
13,0,-13,0.332679,84,2,27
20000,99000,79000,0.212443,111,7.4,80
0,0,0,0.029757,90,6,18
0,0,0,0.166513,82,0,53
0,0,0,0.918116,98,6,18
7000,424760,417760,23.307949,77,6.9,878
0,0,0,0.022173,80,7.5,10769
220000,2040920,1820920,14.269792,81,6.6,28
9000,0,-9000,0.642552,85,5.9,35
0,0,0,1.444476,120,7,35
0,0,0,1.929883,90,6.3,99
